content_ko	content_en
다른 사람들이 겉모습만 보고는 절대 알 수 없는 것을 적어보세요.	Write down something others would never guess about you just by looking at you.
당신의 완벽한 하루를 설명하세요!	Describe your perfect day!
어떻게 지내냐는 질문에 얼마나 자주 진실하게 대답하나요?	When you're asked how are you, how often do you answer truthfully?
최근에 생각을 바꾼 것이 있나요?	Have you changed your mind about anything recently?
정말로, 어떻게 지내세요?	How are you, really?
낯선 사람이 당신의 인생을 바꾼 적이 있나요?	Has a stranger ever changed your life?
낯선 사람이 준 최고의 칭찬은 무엇인가요?	What's been the best compliment a stranger has ever given you?
음악 라이브러리를 셔플해 보세요. 첫 번째로 나오는 노래를 설명해 주세요!	Press shuffle on your music library. Explain the first song that comes up!
더 자주 받고 싶은 칭찬은 무엇인가요?	What is a compliment you wish you received more frequently?
이 인생의 장에 제목을 붙인다면 무엇일까요?	What title would you give this chapter in your life?
당신에 대해 바꾸고 싶지 않은 것은 무엇인가요?	What is something you wouldn't want to change about yourself?
무엇을 더 갈망하나요?	What do you crave more of?
당신의 어린 자아가 오늘의 당신의 삶을 믿지 못할 것은 무엇일까요?	What would your younger self not believe about your life today?
지금 당신의 인생에서 가장 답을 찾고 있는 질문은 무엇인가요?	What question are you trying to answer most in your life right now?
가장 이른 행복의 기억은 무엇인가요?	What has been your earliest recollection of happiness?
문장을 완성하세요: 낯선 사람들은 나를 _______라고 묘사할 것입니다. 나는 _______라는 것을 알고 있습니다.	Finish the sentences: Strangers would describe me as _______. Only I know that I am _______.
당신에게 가장 설명할 수 없는 일은 무엇인가요?	What is the most unexplainable thing that's ever happened to you?
마지막으로 어머니에게 거짓말한 것은 무엇인가요?	What is the last thing you lied to your mother about?
아직도 자신에게 증명하려고 하는 것은 무엇인가요?	What are you still trying to prove to yourself?
실패와 성공 중 무엇이 더 두렵나요? 왜 그렇죠?	What are you more afraid of, failure or success? And why?
사랑한다는 말을 했지만 진심이 아니었던 적이 있나요? 그렇다면 왜 그렇죠?	Have you ever told someone I love you but didn't mean it? If so, why?
당신이 자신에 대해 가지고 있는 이미지가 사람들이 보는 이미지와 일치한다고 생각하나요?	Do you think the image you have of yourself matches the image people see you as?
무언가를 고백해 보세요.	Admit something.
당신이 해냈다면, 당신이 무적이 아니었다는 것을 깨달은 순간은 언제인가요?	If you have, when was the moment you realized you weren't invincible?
당신의 인생에서 더 깊이 알고 싶은 사람이 있다면 누구이며, 왜 그렇죠?	If you could get to know someone in your life on a deeper level, who would it be and why?
대부분의 사람들이 사랑하는 것을 강하게 싫어하는 것을 생각해 보세요.	Think of something you strongly dislike that most people love.
사랑에 빠진다는 느낌을 한 단어로 표현해 보세요.	How would you describe the feeling of being in love in one word?
육체적이지 않은 가장 큰 고통은 무엇이었나요?	What's the most pain you've ever been in that wasn't physical?
가장 오랫동안 배워야 했던 교훈은 무엇인가요?	What lesson took you the longest to unlearn?
마지막으로 자신에게 놀란 적은 언제인가요?	When was the last time you surprised yourself?
질문을 한 가지 해보세요. 두려워서 묻지 못했던 질문.	Ask a question you'd be too afraid to ask. Something you wouldn't dare to ask.
당신의 인생에서 무엇이 잘 되고 있나요? 무엇이 아픈가요?	What part of your life works? What part of your life hurts?
지금 그리운 사람이 있나요? 그 사람도 당신을 그리워하고 있다고 생각하나요?	Are you missing anyone right now? Do you think they are missing you too?
올해 가장 행복한 기억은 무엇인가요?	What's been your happiest memory this part year?
포기한 꿈은 무엇인가요?	What is a dream you've let go of?
그리워하는 감정이 있나요?	Is there a feeling you miss?
당신의 방식대로: 누구와 함께 있고 싶나요? 어디에 있고 싶나요? 그리고 무엇을 하고 싶나요?	If you could have it your way: who would be with? Where would you be? & What would you be doing?
모든 사람에게 소명이 있다고 생각하나요? 그렇다면, 내가 내 소명을 찾았다고 생각하나요?	Do you believe everyone has a calling? If so, do you think I've found mine?
현재 순간에 가장 감사한 것은?	Share something you're most grateful for in this current moment.
어떻게 하면 당신의 취약성을 얻을 수 있나요?	How does one earn your vulnerability?
지금 한 단어로 당신의 기분을 설명해 주세요.	In one word, describe how you feel right now.
지금 당장 들어야 할 것은 무엇인가요?	What do I need to hear right now?
자신만의 질문을 만들어보세요. 신중하게 만들어야 합니다.	Create your own question. Make it count.
당신을 정의하는 가장 대표적인 특성은 무엇이라고 생각하나요?	What is your defining characteristic?
생일을 어떻게 축하하는 것을 좋아하나요?	How do you like to celebrate your birthday?
시도해 보고 싶은 음식이 있나요?	Are there any foods that you would like to try?
세계를 여행하는 동안 피하고 싶은 곳이 있나요?	If you were travelling round the world, are there any places you avoid?
어디를 가든 항상 가지고 다니는 것은 무엇인가요?	What do you bring with you everywhere you go?
몇 살까지 살고 싶나요?	What age do you want to live to?
당신의 성격 중 가장 좋은 측면은 무엇인가요?	What is the best aspect of your personality?
발렌타인 데이를 어떻게 축하하는 것을 좋아하나요?	How do you like to celebrate valentines?
개인 생활에서 어떤 성공을 거두었나요?	What are some successes you've had in your personal life?
4성급 호텔과 2성급 호텔의 차이점은 무엇일까요?	What differences would you expect between a four-star and a two-star hotel?
과도하게 상업화된 휴일은 무엇인가요?	What holidays have been over commercialized?
휴가를 얼마나 미리 계획하는 것을 좋아하나요?	How far in advance do you like to plan your vacation?
식료품 쇼핑을 할 때마다 항상 사는 것은 무엇인가요?	What do you get every time you go grocery shopping?
마지막으로 간 콘서트는 무엇이었나요?	What was the last concert you went to?
아름다움은 보는 사람의 눈에만 있는 것인가요, 아니면 어떤 것은 보편적으로 못생겼나요?	Is beauty only in the eye of the beholder, or are some things universally ugly?
부모님을 얼마나 자주 보나요?	How often do you see your parents?
보통 규칙을 어기나요, 따르나요?	Do you usually break the rules or follow them?
식당 내부를 어떤 스타일로 좋아하나요?	What kind of interior do you like a restaurant to have?
변기에 무언가를 떨어뜨린 적이 있나요?	Have you ever dropped anything in the toilet?
스트레스를 해소하기 위해 무엇을 하나요?	What do you do to get rid of stress?
어른이 되면 어떤 문제를 해결하고 싶나요?	What problems do you want to solve when you grow up?
당신만의 지옥은 어떻게 생겼나요?	What does your own personal hell look like?
가장 창피한 순간은 무엇인가요?	What is your most embarrassing moment?
당신의 인생에서 가장 큰 기쁨을 가져다주는 사람은 누구인가요?	Who in your life brings you the most joy?
선과 악을 누가 정의하나요?	Who defines good and evil?
가장 웃긴 일은 무엇인가요?	What is the funniest thing that's ever happened to you?
다른 사람의 겨드랑이를 핥는 것과 다른 사람이 내 겨드랑이를 핥는 것 중 어떤 것을 선택하겠습니까?	Would you rather lick someone else's armpit or have someone else likc your armpit?
신뢰가 사랑보다 더 중요한가요?	Is trust more important than love?
당신의 시그니처 요리는 무엇인가요?	What is your signature dish?
자유란 무엇인가요?	What is freedom?
가장 아름다운 노래는 무엇인가요?	What is the most beautiful song you have heard?
가장 싫어하는 계절은 언제인가요?	What time of year do you dislike the most?
가장 가치 있는 소유물은 무엇인가요?	What is the most valuable thing that you own?
어떻게 죽고 싶나요?	How would you like to die?
가장 좋아하는 TV 프로그램은 무엇인가요?	What is your favorite TV show?
과속 딱지를 받은 적이 있나요?	Have you ever gotten a speeding ticket?
인생에서 겪은 도전들이 당신을 더 나은 사람으로 만들었다고 생각하나요?	Do you think that the challenges you have faced in your life have made you a better or worse person?
마지막으로 본 재미있는 동영상은 무엇인가요?	What was the last funny video you saw?
단기 목표는 무엇인가요?	What are some of your short-term goals?
혼자 휴가를 간 적이 있나요?	Have you ever gone on vacation by yourself?
어떤 책 장르를 좋아하나요?	What book genres do you like to read?
깔끔한 편인가요, 지저분한 편인가요?	Are you messy or organized?
마지막으로 영화관에 간 것은 언제인가요?	When was the last time you went to a movie theater?
가장 과소평가되거나 과대평가된 TV 프로그램은 무엇인가요?	What's the most underrated or overrated TV show?
가장 긴 책은 무엇인가요?	What is the longest book you have read?
가장 큰 성공은 무엇인가요?	What is your biggest success?
사계절이 있는 곳에서 사는 것이 좋을까요, 아니면 한 계절이 대부분을 차지하는 곳에서 사는 것이 좋을까요?	Is it better to live where there are four seasons or where one season takes up most of the year?
10년 후의 전화기는 어떻게 변할까요?	What will phones be like in 10 years?
당신의 대가족 중 가장 흥미로운 사람은 누구인가요?	Who is the most interesting person in your extended family?
가장 좋아하는 계절은 무엇인가요?	What is your favorite season?
휴일을 발명할 수 있다면, 어떤 휴일을 만들겠습니까?	If you could invent a holiday, what would it be?
어린 시절 어떤 만화를 보았나요?	What cartoons did you watch as a child?
공포 영화를 좋아하나요?	Do you like horror movies?
가장 뛰어난 기술이나 재능은 무엇인가요?	What is your best skill or talent?
자연 지역을 아름답게 만드는 요소는 무엇인가요?	What features make a natural area beautiful?
인기 음악과 상대적으로 알려지지 않은 음악 중 어떤 것을 더 좋아하나요?	Which do you prefer, popular music or relatively unknown music?
당신을 정의하는 것은 무엇인가요?	What defines you?
언제 은퇴하고 싶나요?	When do you want to retire?
가장 큰 도전 과제는 무엇인가요?	What are some of the biggest challenges you have faced?
돈을 어디에 쓰는 것을 좋아하나요?	What do you like to spend your money on?
정말로 하고 싶은 일을 막는 것은 무엇인가요?	What things hold you back from doing the things that you really want to?
세상을 더 나은 곳으로 만들 계획이 있나요?	How do you plan to make the world a better place?
당신의 차에 이름이 있나요?	Does your car have a name?
오늘 하나의 소원이 이루어지길 원하나요, 아니면 5년 후에 세 개의 소원이 이루어지길 원하나요?	Would you rather have one wish granted today or three wishes granted five years from now?
영혼의 반려자를 믿나요?	Do you believe in soul mates?
이번 주의 하이라이트는 무엇이었나요?	What was the highlight of your week?
모든 생명이 동일한 가치를 가지고 있다고 생각하나요?	Are some lives more valuable than others?
당신의 첫 스마트폰은 무엇이었나요?	What was your first smartphone?
TV 프로그램이 어떻게 변해왔나요?	How have TV shows changed over the years?
매일 방문하는 웹사이트 세 곳은 어디인가요?	What three websites do you visit daily?
많은 도시에서 주차 문제가 있습니다. 당신의 도시에서 주차를 어떻게 개선할 수 있을까요?	Parking is a problem in many cities. How could parking in your city be improved?
당신이 왕/여왕이라면, 당신의 왕좌는 어떻게 생겼을까요?	If you were a king/queen, what would your throne look like?
봉제인형과 함께 자나요?	Do you sleep with a stuffed animal?
언론인들이 보도하는 뉴스의 정확성을 얼마나 책임져야 한다고 생각하나요?	How accountable should journalists be to making sure the news they are reporting is accurate?
전문적으로 이루고 싶은 것은 무엇인가요?	What do you hope to achieve in your professional life?
완벽한 주말은 무엇인가요?	What would be your perfect weekend?
지금 인기가 많은 사람 중 정말로 좋아하는 사람은 누구인가요?	Who is someone who is popular now that you really like?
휴대폰에서 가장 유용한 앱은 무엇인가요?	What is the most useful app on your phone?
가장 좋아하는 위로 음식은 무엇인가요?	What's your favorite comfort food?
가장 좋아하는 사탕은 무엇인가요?	What is your favorite candy?
당신은 좋은 친구인가요?	Are you a good friend?
모든 악기를 마스터할 수 있다면, 아니면 모든 언어를 유창하게 할 수 있다면 어떤 것을 선택하겠습니까?	Would you rather be a master of every musical instrument or be fluent in every language?
가장 웃긴 TV 시리즈는 무엇인가요?	What's the funniest TV series you have seen?
가장 어려운 스포츠는 무엇인가요?	What is the hardest sport to excel at?
더 키가 작았으면 좋겠나요?	Do you wish you were shorter?
비행이 8시간 지연되는 것과 짐을 잃어버리는 것 중 무엇을 선택하겠습니까?	Would you rather your flight be delayed by 8 hours or lose your luggage?
실패할 수 없다는 것을 알면 무엇을 하겠습니까?	If you knew you couldn't fail, what would you do?
다른 사람은 신경 쓰지 않지만 정말 짜증나는 것은 무엇인가요?	What is something that really annoys you but doesn't bother most people?
돈으로 행복을 살 수 없다면, 돈 없이도 진정으로 행복할 수 있을까요?	If money cannot buy happiness, can you ever be truly happy with no money?
당신의 삶이 하나의 식사라면, 어떤 식사일까요?	If your life was a meal, what kind of meal would it be?
여행 그룹 패키지에 대해 어떻게 생각하나요?	What do you think of tour group packages?
냄새를 맡을 수 없게 되는 것과 주변의 모든 것을 코앞에서 맡는 것처럼 맡는 것 중 무엇을 선택하겠습니까?	Would you rather have no sense of smell or smell everything near you as though it were right in front of your nose?
받은 최고의 조언은 무엇인가요?	What is the best piece of advice you've received?
과대평가된 여행지는 어디였나요?	What was the most over hyped place you've traveled to?
사용하기 정말 어려운 기술은 무엇인가요?	What piece of technology is really frustrating to use?
패션이 사회에 어떤 도움을 줄까요?	Does fashion help society in any way?
가장 아름다운 곳은 어디였나요?	Where is the most beautiful place you have been?
절대 직면하고 싶지 않은 도전 과제는 무엇인가요?	What is a challenge you would never want to face?
긴 하루를 보낸 후 친구들과 어울리는 것을 더 좋아하나요, 아니면 혼자 시간을 보내는 것을 더 좋아하나요?	After a long day, do you prefer to hang out with friends or spend time alone?
가족 중 선물을 잘 주는 사람은 누구인가요?	Who in your family gives good gifts?
이미 달성한 목표는 무엇인가요?	What are some goals you have already achieved?
종이책과 전자책 중 어떤 것을 더 선호하나요?	Do you prefer physical books or eBooks?
가장 좋아하는 셔츠는 무엇인가요?	What is your favorite shirt?
학교나 직장에서 문제를 일으킨 적이 있나요?	What is something that you have gotten in trouble for at school/work?
죽음 후에 무엇이 일어난다고 생각하나요?	What do you think happens after death?
매일 일어나는 기적은 무엇인가요?	What is a miracle that happens every day?
언론이 사회에 어떤 역할을 하나요? 잘 하고 있나요?	How does journalism serve society? Is it doing a good job?
혼자 여행하는 것을 좋아하나요, 아니면 그룹과 함께 여행하는 것을 좋아하나요?	Do you prefer traveling alone or with a group?
언론인이라는 직업이 존경받을 만한 직업이라고 생각하나요?	Is being a journalist a respectable job?
여행을 좋아하나요, 아니면 집에 가까이 있는 것을 선호하나요?	Do you prefer to travel or stay close to home?
옳은 일을 하는 것과 일을 제대로 하는 것 중 무엇이 더 중요하다고 생각하나요?	Should people care more about doing the right things, or doing things right?
고양이와 개 중 어떤 것을 더 좋아하나요?	Do you prefer cats or dogs?
히치하이킹에 대해 어떻게 생각하나요?	What is your opinion of hitch-hiking?
선물 쇼핑을 좋아하나요?	Do you enjoy shopping for gifts?
좋은 기억을 떠올리게 하는 냄새는 무엇인가요?	What smell brings back great memories?
받은 교육이 당신의 삶을 어떻게 바꾸었나요?	How has the education you received changed your life?
온라인 교육에 대해 어떻게 생각하나요?	What do you think of online education?
친구와 지인의 차이점은 무엇인가요?	What is the difference between friends and acquaintances?
친구와 가족이 당신을 어떻게 묘사할까요?	How would your friends and family describe you?
휴대폰을 집에 두고 나가면 어떤 기분이 드나요?	How do you feel if you accidentally leave your phone at home?
이상한 믿음이 있나요?	What are some strange beliefs that you have?
매운 음식을 좋아하나요?	Do you like spicy food?
가장 긴 비행은 무엇이었나요?	What is the longest plane trip you have taken?
가장 도전적인 직업은 무엇인가요?	What is the most challenging job you can think of?
마지막으로 읽은 책은 무엇인가요?	What was the last book you read?
뷔페에 대해 어떻게 생각하나요?	What do you think buffets?
암벽 등반을 해본 적이 있나요?	Have you ever been rock climbing?
항상 최신 휴대폰을 가지고 있나요?	Do you always have the latest phone?
복권에 당첨되면 계속 일하거나 학교에 다닐 건가요?	If you win the lottery would you still be working or going to school?
세 가지 소원을 이룰 수 있다면, 무엇을 원하겠습니까?	If you had three wishes, what would they be?
큰 가족 모임에 참석한 적이 있나요? 어땠나요?	Have you ever been to any large family reunions? How was it?
여자로서 가장 힘든 것은 무엇인가요?	What's the hardest thing about being a girl?
한 번도 해본 적 없지만 해보고 싶은 것은 무엇인가요?	What is something you have never done but would like to do?
가장 짜증나는 습관은 무엇인가요?	What is the most annoying habit someone can have?
남자로서 가장 힘든 것은 무엇인가요?	What's the hardest thing about being a boy?
집을 얼마나 자주 청소하나요?	How often do you clean your home?
당신의 삶에 가장 큰 영향을 미친 책은 무엇인가요?	What book has had the biggest impact on your life?
휴가를 계획할 때 환경 문제를 고려하나요?	Do you consider environment issues when you plan and take a vacation?
마지막으로 정말 열심히 일한 것은 언제인가요?	What was the last time you worked incredibly hard?
샤워를 하지 않고 가장 오래 버틴 시간은 얼마인가요?	What's the longest you've gone without showering?
휴대폰을 얼마나 자주 사용하나요?	How often do you use your phone?
언론이 어떻게 개선될 수 있을까요?	How can journalism be improved?
가장 놀라운 일몰을 본 곳과 시간은 언제인가요?	Where and when was the most amazing sunset you have ever seen?
가장 자주 사용하는 교통수단은 무엇인가요?	What method of transport do you use most often?
진실이란 무엇인가요?	What is truth?
어떤 초능력을 가지고 싶나요?	If you could have any super power, what would it be?
매우 다른 문화적 배경을 가진 사람들이 평화롭게 함께 살 수 있을까요?	Can people with vastly different cultural backgrounds live together peacefully?
많은 활동이 포함된 휴가를 좋아하나요, 아니면 더 편안한 휴가를 좋아하나요?	Do you prefer vacation which include a lot of activities or more relaxing ones?
이상적인 휴가지가 어디인가요?	Where would your ideal holiday destination be?
긴 크루즈 여행을 가고 싶나요?	Would you like to go on a long cruise?
책과 영화 중 어떤 것을 더 좋아하나요?	Which do you prefer, books or movies?
휴가가 끝나면 일(또는 학교)로 돌아가는 것이 기쁜가요, 아니면 두려운가요?	When your holiday is finished are you glad to get back to work (or school) or do you dread it?
지난 주말에 특별한 일을 했나요?	Did you do anything special this past weekend?
반에서 가장 웃긴 아이였나요, 아니면 선생님의 애완동물이었나요?	Were you the class clown or teacher's pet?
누군가가 당신의 생명을 구한 적이 있나요?	Has anyone ever saved your life?
어디에서 자랐나요?	Where did you grow up?
쉬는 시간에 무엇을 했나요?	What do you do during recess?
어떤 기술이 중세 유럽 사람들에게 기적이나 마법처럼 보일까요?	What piece of technology would look like magic or a miracle to people in medieval Europe?
상한 우유를 마시는 것과 공공장소에서 바지를 적시는 것 중 무엇을 선택하겠습니까?	Would you rather drink a cup of spoiled milk or pee your pants in public?
SF 영화에서 어떤 기술을 가장 가지고 싶나요?	What technology from a science fiction movie would you most likely to have?
가장 이상한 영화는 무엇이었나요?	What's the strangest movie you have ever seen?
세계에서 누구에게나 전화를 걸어 한 시간 동안 대화할 수 있다면 누구에게 전화를 걸겠습니까?	If you could call up anyone in the world and have a one hour conversation, who would you call?
다섯 가지 감각 중 하나를 포기해야 한다면, 어떤 것을 선택하겠습니까? 왜 그렇죠?	If you had to give up one of your five senses, which one would it be and why?
세계를 어떻게 바꾸고 싶나요?	How would you change the world if you could?
다음 큰 기술 발전은 무엇이 될 것 같나요?	What do you think the next big technological advance will be?
당신의 성격 중 가장 유용한 특징은 무엇인가요?	Which of your personality traits has been the most useful?
유행하는 옷을 입는 것과 편안한 옷을 입는 것 중 어떤 것을 더 좋아하나요?	Do you prefer to wear fashionable clothes or comfortable clothes?
가장 좋은 생일 선물은 무엇이었나요?	What was the best birthday gift you ever had?
신발을 벗을 때 끈을 풀나요?	Do you untie your shoes before taking them off?
가장 최근에 성공한 일은 무엇인가요?	What is the most recent success you've had?
항상 속삭이기만 하거나 항상 소리쳐야 한다면, 어떤 것을 선택하겠습니까?	Would you rather only be able to whisper or only be able to shout everything?
운명을 믿나요?	Do you believe in fate?
앱 개발자들이 정말 짜증나게 하는 것은 무엇인가요?	What do app makers do that really annoys you?
도전이 사람의 성격을 향상시키나요?	Do you think that challenges improve a person's character?
영화를 극장에서 보는 것과 집에서 보는 것 중 어떤 것을 더 선호하나요?	Do you prefer to watch movies in the theater or at home?
잠들기 전에 마지막으로 생각하는 것은 무엇인가요?	What is the last thing that you think of before you go to sleep?
예술이 사회에 어떤 역할을 하나요?	What is the purpose of art in society?
가장 좋아하는 장난감은 무엇인가요?	What is your favorite toy?
한 번 해본 것이지만 다시는 하고 싶지 않은 것은 무엇인가요?	What is something you've but would never do again?
삶에서 가장 아름다운 것은 무엇인가요?	What is the most beautiful thing in your life?
당신의 인생이 닮고 싶은 TV 프로그램은 무엇인가요?	Which TV show do you want your life to be like?
스스로 결정을 내리나요, 아니면 다른 사람들이 대신 결정을 내리도록 하나요?	Do you make your own decisions, or let others make them for you?
멍청이들 사이의 천재로 사는 것과 천재들 사이의 멍청이로 사는 것 중 어떤 것을 선택하겠습니까?	Would you rather be a genius in a world of morons, or a moron in a world of geniuses?
정말 기뻤던 패션 트렌드는 무엇인가요?	What is a fashion trend you are really glad went away?
항상 기분 좋게 해주는 노래는 무엇인가요?	What song always puts you in a good mood?
지난 주에 가장 늦게까지 깨어있었던 시간은 언제인가요?	What is the latest you've stayed up this past week?
집에서 가장 좋은 방은 어디인가요?	What is the best room in your house?
꿈의 집을 설명해 주세요.	Describe your dream house.
삶의 의미는 무엇인가요?	What do you think is the meaning of life?
가장 끔찍한 직업은 무엇이었나요?	What was the worst job that you've ever had?
휴가를 갈 때 투어에 참여하는 것과 모든 것을 직접 계획하는 것 중 어떤 것을 선호하나요?	When going on a vacation, would you prefer to join a tour or plan out everything by yourself?
어린 시절 가장 좋아했던 책은 무엇인가요?	What was your favorite book as a child?
가장 미친 다이어트는 무엇이었나요?	What is the craziest diet you've heard of?
어떤 아이였나요? 수줍음이 많았나요, 문제를 일으키는 아이였나요, 조용했나요?	What type of kid were you? Shy, trouble maker, quiet?
교육의 미래는 어떻게 될까요?	What will the future of education be?
사람들이 다른 사람들을 도와야 할 의무가 있나요?	Do people have an obligation to help others?
가장 좋아하는 어린이 책은 무엇인가요?	What is your favorite children's book?
보기에는 끔찍하지만 맛은 훌륭한 음식은 무엇인가요?	What food looks disgusting but tastes delicious?
다른 사람들의 성격 중 어떤 점을 싫어하나요?	What personality traits in other people do you hate?
오늘 누군가를 도왔나요?	Did you help anyone today?
주차 티켓을 몇 번 받았나요?	How many parking tickets have you received?
기분이 나쁠 때 기분을 개선하기 위해 무엇을 하나요?	What do you do to improve your mood when you are in a bad mood?
당신 앞에 다른 세계로 가는 포털이 열립니다. 들어가시겠습니까?	A portal to another world opens in front of you. Do you go through?
리더인가요, 팔로워인가요?	Are you a leader or a follower?
음악을 듣기 위해 무엇을 사용하나요?	What do you use to listen to music?
가장 심한 부상은 무엇이었나요?	What is the worst injury you've had?
가장 어리석은 두려움은 무엇인가요?	What is the silliest fear you have?
가족 중 당신과 가장 닮은 사람은 누구인가요?	Who in your family are you most like?
최근에 본 최악의 영화는 무엇인가요?	What's the worst movie you have seen recently?
표준화된 시험에 대해 어떻게 생각하나요?	What do you think of standardized tests?
초등학교 때 가장 친한 친구는 누구였나요?	Who was your best friend in elementary school?
하루 중 가장 좋아하는 식사는 무엇인가요?	What is your favorite meal of the day?
이번 주말에 어떤 계획이 있나요?	What are your plans for this weekend?
미래로 가는 것과 과거로 가는 것 중 무엇을 선택하겠습니까?	Would you rather go forward or back in time?
마지막으로 전문 마사지나 아마추어 마사지를 받은 것은 언제인가요?	When was the last time you got a professional or amateur massage?
시간이 지나면서 마사지는 더 인기를 끌까요, 아니면 덜 인기를 끌까요?	Do you think getting massages will become more or less popular as time goes by?
가장 좋아하는 음악가는 누구인가요?	Who is your favorite music artist?
가장 좋아하는 운동 선수는 누구인가요?	Who are some of your favorite athletes?
스포츠를 정의하는 것은 무엇인가요? 낚시는 스포츠인가요? 비디오 게임 대회는 어떤가요?	What defines a sport? Is fishing a sport? How about video game tournaments?
승마에 대해 어떻게 생각하나요?	What is your opinion of horse riding?
이상적인 크리스마스는 무엇인가요?	What's an ideal Christmas for you?
부드럽고 편안한 마사지와 강한 마사지 중 어떤 것을 선호하나요?	Do you prefer gentle relaxing massages or a strong massage?
저녁 일과는 어떻게 되나요?	What is your evening routine like?
가장 중독성 있는 모바일 게임은 무엇이었나요?	What's the most addictive mobile game you have played?
1년 남았다는 사실을 알게 된다면 무엇을 하겠습니까?	If you knew that you only had a year left to live, what would you do?
잠을 많이 자나요, 아니면 적게 자나요?	Are you a heavy or a light sleeper?
미래를 얼마나 계획하나요?	How much do you plan for the future?
가장 오래된 친구는 누구인가요? 어디에서 만났나요?	Who is your oldest friend? Where did you meet them?
가장 좋아하는 피자 토핑은 무엇인가요?	What is your favorite pizza topping?
정부가 교육을 더 효율적으로 만들기 위해 무엇을 할 수 있을까요?	How can governments make education more efficient?
신생아에게 줄 한 가지 조언은 무엇인가요?	What one piece of advice would you offer to a newborn child?
항상 10분 늦게 도착하는 것과 항상 20분 일찍 도착하는 것 중 어떤 것을 선택하겠습니까?	Would you rather be 10 minutes late or be 20 minutes early for everything?
새벽 3시 이후에 얼마나 자주 깨어 있나요?	How often do you stay up past 3 a.m.?
가장 좋아하는 신발은 무엇인가요?	What is the best pair of shoes you have ever owned?
기술이 인류를 구할까요, 아니면 파괴할까요?	Will technology save the human race or destroy it?
아침에 샤워하나요, 아니면 밤에 샤워하나요? 왜 그렇죠?	Do you shower in the morning or at night? Why?
가장 좋아하는 의류 브랜드는 무엇인가요?	What is your favorite clothing brand?
놀라운 일을 하는 앱이 휴대폰에 갑자기 나타났다면, 무엇을 할까요?	An app mysteriously appears on your phone that does something amazing. What does it do?
가장 감동적인 영화 장면은 무엇인가요?	What movie scene choked you up the most?
가장 좋아하는 아이스크림 맛은 무엇인가요?	What is your favorite ice cream flavor?
좋은 차와 좋은 집 중 무엇이 더 중요한가요?	Which is more important, a great car or a great house?
가장 좋아하는 영화는 무엇인가요?	What is your favorite movie?
질문에 답할 수 없게 사는 것과 질문을 할 수 없게 사는 것 중 무엇을 선택하겠습니까?	Would you rather go through life unable to answer any questions or unable to ask any questions?
가장 끔찍한 식당 경험은 무엇이었나요?	What was your worst restaurant experience?
여행 중 사고를 당한 적이 있나요?	Have you ever had an accident while travelling?
인간 본성의 가장 좋은 부분과 나쁜 부분은 무엇인가요?	What are the best and worst parts of human nature?
실패를 승리로 바꾼 적이 있나요?	Have you ever turned a failure into a win?
대통령이 되면 가장 먼저 무엇을 하겠습니까?	If you became president, what is the first thing you would do?
명예란 무엇인가요?	What does honor mean to you?
예술 작품을 아름답게 만드는 것은 무엇인가요?	What makes a piece of art beautiful to you?
다른 나라에 있을 때 보통 문구책을 사서 현지 언어를 시도해 보나요?	When you are in another country, do you usually buy a phrase book to attempt to speak the local language?
가장 흥미진진한 스포츠는 무엇인가요?	Which sport is the most exciting to watch?
무서운 것은 무엇인가요?	What are you afraid of?
당신 나라의 교육 시스템에 대해 좋은 점과 나쁜 점은 무엇인가요?	What are some good and bad things about the education system in your country?
가장 창피한 옷은 무엇인가요?	What is the most embarrassing piece of clothing you own?
당신만의 지옥은 어떻게 생겼나요?	What does your own personal hell look like?
가장 이상한 앱은 무엇이었나요?	What is the strangest app you have heard or tried?
다음에 여행하고 싶은 곳은 어디인가요?	Where would you like to travel next?
운전할 때 가장 짜증나는 것은 무엇인가요?	What annoys you most when you are driving?
긴장을 풀기 위해 무엇을 하나요?	What do you like to do to relax?
전통적인 마사지 외에 다른 종류의 마사지를 시도해 본 적이 있나요?	Have you tried any different types of massages other than the traditional kind?
인생의 가치는 얼마인가요?	What is a year of life worth?
성격은 얼마나 유전적이고 얼마나 환경적일까요?	How much of personality is genetic and how much is from the environment?
자전거가 있나요?	Do you have a bicycle?
당신의 인생에서 가장 좋은 시기는 언제였나요? 앞으로 가장 좋은 시기는 언제일 것 같나요?	What was the best time period of your life? What do you think will be the best time period of your entire life?
캠프파이어를 시작하는 데 얼마나 능숙한가요?	How good are you at starting a campfire?
선물 주기는 모든 문화에서 공통적인가요?	Is gift giving common among all cultures?
가장 좋아하는 무알코올 음료는 무엇인가요?	What's your favorite non-alcoholic drink?
장기 목표는 무엇인가요?	What are some of your long-term goals?
사람들이 본질적으로 선하다고 믿나요?	Do you believe people are inherently good?
가장 기억에 남는 할로윈 의상은 무엇인가요?	Best Halloween costume you ever had?
부자가 되고 진정한 사랑을 찾지 못하는 것과 가난하고 진정한 사랑을 찾는 것 중 무엇을 선택하겠습니까?	Would you rather be rich and never find true love or be poor and find true love?
가장 활동적인 계절은 언제인가요?	Which season are you most active in?
시간이 멈추고 당신만 하루 동안 움직일 수 있다면 무엇을 하겠습니까?	Time freezes for everyone but you for one day. What do you do?
휴가에서 흥미로운 기념품을 가져오려고 노력하나요?	Do you usually try to bring back interesting souvenirs from your holidays?
세상에서 한 가지를 바꿀 수 있다면 무엇을 바꾸겠습니까?	If you could choose just one thing to change about the world, what would it be?
선물 포장이 중요합니까, 아니면 선물만 중요합니까?	Does it matter how a gift is wrapped or is it only the gift that matters?
젊었을 때 어떤 트렌드를 따랐나요?	What trends did you follow when you were younger?
삶을 얼마나 통제할 수 있나요?	How much control do you have over your life?
요즘 다시 유행하는 오래된 트렌드는 무엇인가요?	What old trend is coming back these days?
이상적인 세상에서 다음 해 당신의 삶은 어떻게 될까요?	In an ideal world, what would the next year in your life look like?
지금 살고 있는 곳에서 사랑하는 두 가지는 무엇인가요?	What are two things you love about where you live right now?
설명할 수 없고 아직도 설명할 수 없는 일이 있었나요?	Has anything ever happened to you that you could not, and still cannot, explain?
해외에서 1년을 보내야 한다면 어디로 가겠습니까?	If you had to spend a year abroad, where would you go?
과거, 현재, 미래 중 어느 쪽에 가장 연결되어 있다고 느끼나요?	Do you feel most connected to the past, present, or future?
매일 수천 명이 볼 수 있는 광고판에 어떤 메시지를 넣고 싶나요?	What message would you put on a billboard for thousands of people to see every day?
자녀가 있거나 자녀를 가질 계획이라면, 그들에게 전하고 싶은 교훈은 무엇인가요?	If you have or were to have children, what is one lesson you would like to share with them?
10년 전으로 돌아가 자신에게 한 가지를 말할 수 있다면 무엇을 말하겠습니까?	If you were to go back in time 10 years and tell yourself one thing, what would it be?
지난해 당신은 어떻게 변했나요?	How have you changed this past year?
지금까지 가장 좋아하는 나이는 몇 살이었나요? 왜 그렇죠?	What has been your favorite age so far? Why?
지난 10년 동안 영적 견해가 어떻게 변했나요?	How have you spiritual views changed in the last decade?
마지막으로 진정으로 감사함을 느꼈던 때는 언제였나요?	When was the last time you felt truly appreciated?
누군가에게 절대 갚을 수 없다고 느꼈던 순간이 있었나요? 언제였나요?	Has there ever been a time in your life when you felt you could never fully repay someone? When was it?
당신 인생에서 가장 감사한 사람은 누구인가요?	Who in your life are you most grateful for?
자신의 행동으로 인해 인생의 방향이 바뀐 순간이 있었나요? 무엇이었나요?	Was there ever a moment when your life changed course because of an action you took? What was it?
정의와 용서 중 무엇이 더 중요합니까?	What is more important to you: justice or forgiveness?
완전히 정직하지 않아도 되는 때는 언제인가요?	When is it okay to not be completely honest?
오늘 죽는다면 누군가에게 가장 후회할 일이 무엇일까요? 왜 아직 말하지 않았나요?	If you were to die today, what would you most regret not having told someone? Why haven't you told them yet?
농담으로는 절대 할 수 없는 일은 무엇인가요?	What, if anything, is too serious to be joked about?
후회한 적이 있나요?	Do you have any regrets?
목격한 가장 용감한 행동은 무엇인가요?	What is the greatest act of bravery you have witnessed?
지금 가지고 있는 비이성적인 두려움은 무엇인가요?	What irrational fears do you have now?
가장 많이 배운 실수는 무엇인가요?	What mistake have you learned the most from?
당신의 약점(혹은 가장 큰 약점)은 무엇인가요?	What is your kryptonite (or greatest weakness)?
어떤 사회적 문제가 당신을 가장 화나게 하나요?	What social issues fire you up?
버킷리스트에 아직 남아 있는 두 가지는 무엇인가요?	What are two things still on your bucket list?
오랫동안 꿈꾸어 왔지만 아직 하지 않은 일은 무엇인가요?	Is there something that you've dreamed of doing for a long time? Why haven't you done it?
성공이 보장된다면 어떤 경로를 선택하겠습니까?	If you could pick any career path and you were guaranteed to be successful, what would you choose?
당신의 인생을 형성한 것은 무엇을 읽고, 보고, 듣고 했나요?	What have you read, seen, or listened to that has shaped your life?
자기 인식이나 실패에 대한 걱정 없이 어떤 형태의 표현을 탐구하고 싶나요?	If you weren't self-conscious or worried about failing, what form of expression would you explore?
당신과 가장 닮은 책, 영화, TV 프로그램의 캐릭터는 누구인가요?	What character from a book, movie, or TV show is most similar to you?
어릴 때 했던 창의적인 활동은 무엇인가요? 왜 더 이상 하지 않나요?	What is something creative you did when you were younger that you no longer do? What don't you do it anymore?
죽을 뻔했던 순간은 언제인가요?	What is the closest you have ever come to dying?
극복하고 싶은 두려움은 무엇인가요?	What is one fear you would like to conquer?
마지막으로 완전히 새로운 것을 시도한 것은 언제인가요?	When was the last time you tried something totally new?
가장 큰 위험을 감수했던 순간은 언제인가요? 다시 기회가 주어진다면 다르게 할 것인가요?	What is the biggest risk you've taken? If you had another chance, would you do anything differently?
집이 불타고 모든 것을 잃었다고 가정합시다. 모든 사람과 애완동물은 안전하지만 하나의 아이템만 구할 수 있습니다. 무엇을 선택하겠습니까?	Your house and everything you own catches fire. All pets and people are safe, but you can save one item. What would you choose?
내세나 환생이 있다면, 이 삶의 어떤 기억을 가지고 가고 싶나요?	If there is an afterlife or reincarnation, what one memory from this life would you bring with you?
놓아버려야 할 것은 무엇인가요?	What are you holding on to that you need to let go of?
얼마나 자주 죄책감을 느끼며, 어떻게 대처하나요?	How often do you feel guilty and how do you deal with it?
기분이 나쁠 때 정말 도움이 되는 것은 무엇인가요?	What's one thing that really helps you when you're feeling down?
당신을 이상하게 만드는 것은 무엇인가요?	What makes you weird?
자신을 더 잘 돌보기 위해 할 수 있는 일은 무엇인가요?	What's one thing you could do to take better care of yourself?
미래의 자신이 지금 하고 있는 일에 감사할 것이라고 생각하나요?	What are you doing right now that your future self will thank you for?
마지막으로 친구를 용서한 것은 언제인가요?	When was the last time you forgave a friend?
관계를 자연스럽게 흘러가게 하는 것이 좋나요, 아니면 의도적으로 유지하는 것이 좋나요?	Is it better to let relationships ebb and flow in and out of our lives or intentionally try and maintain them?
어렸을 때 이상하게 생각했지만 이제는 감사하게 여기는 가족 전통은 무엇인가요?	What family tradition did you think was weird as a kid but you now appreciate?
어린 시절을 바꿀 수 있다면, 무엇을 바꾸겠습니까?	If you could change anything about your childhood, what would it be?
어떻게 사랑에 빠졌는지 알 수 있었나요?	How did you (or will you) know you are in love?
어떻게 기억되고 싶나요?	How do you want to be remembered?
가장 나쁜 습관은 무엇인가요?	What are your worst habits?
5년 후에 죽는다는 것을 알았다면, 지금의 삶에서 무엇을 바꾸겠습니까? 왜 그렇죠?	If you knew that you would die in five years, what would you change about the way you live now? Why?
수정 구슬이 당신의 인생, 세계 또는 다른 것에 대한 진실을 알려줄 수 있다면, 무엇을 알고 싶나요?	If a crystal ball could tell you the truth about your life, the world, or anything else, what would you want to know?
훌륭한 하루를 보내기 위해 어떤 일을 하나요?	What is one thing you do that sets you up for a great day?
"당신의 ""완벽한"" 하루는 어떻게 생겼나요?"	"What does your ""perfect"" day look like?"
가장 좋은 습관은 무엇인가요?	WHat are your best habits?
머리로 결정하나요, 마음으로 결정하나요?	Do you make decisions more with your head or heart?
첫 번째 진정한 친구는 누구였고, 무엇이 그들을 함께하게 만들었나요?	Who was your first true friend and what brought you together?
부모님이 100% 틀렸다고 생각했지만 결국에는 어느 정도 옳다는 것을 깨달았던 순간을 설명해 보세요.	Describe a time you thought your parents were 100% wrong but eventually learned they were kind of right.
부모님이나 조부모님이 만들었던 한 끼 식사를 배우고 싶나요?	What is one meal your parents or grandparents made that you wish you knew how to make?
연락이 끊겼지만 여전히 궁금한 사람은 누구인가요?	Who have you lost touch with but still wonder about?
외향적인가요, 내향적인가요? 왜 그렇죠?	Would you describe yourself as an extrovert or an introvert? Why?
아플 때 기분을 나아지게 하기 위해 사용하는 의식이나 민간요법이 있나요?	Do you have any rituals or home remedies for feeling better when you get sick?
90세까지 산다면, 마지막 60년 동안 30세의 정신이나 신체를 유지하고 싶나요?	If you lived to the age of 90, would you rather retain the mind or body of a 30-year-old for the last 60 years of your life?
모든 감정이 아름다운가요?	Are all emotions beautiful?
낯선 사람이 해준 가장 친절한 일은 무엇인가요?	What is the kindest thing a stranger has ever done for you?
사과를 거부하는 사람을 용서하는 것이 얼마나 어렵나요?	How difficult is it for you to forgive someone who refuses to apologize?
돈이 들지 않고 자연스럽게 일어나는 것 중 항상 미소를 짓게 하는 것은 무엇인가요?	What is one thing that doesn't cost anything, occurs naturally, and always makes you smile?
오랫동안 원했지만 얻었을 때 기대에 미치지 못한 것은 무엇인가요?	What is something you wanted for a long time, but once you acquired it, it didn't quite meet your expectation?
과거에 어떤 것을 수집했나요?	What types of things have you collected in the past?
하루 동안 동물로 변할 수 있다면, 어떤 동물을 선택하겠습니까?	If you could spend a day as any animal, which would you choose?
실패와 시도하지 않음 중 어느 것이 더 나쁜가요?	Which feels worse: failing or not trying?
어린 시절의 모험을 떠올리면 어떤 기억이 떠오르나요?	When you think about adventures in your childhood, what memory comes to mind?
가장 끔찍한 잠자리 경험은 무엇이었나요?	Describe the worst place you've ever tried to sleep.
세 번 이상 본 영화는 무엇인가요?	What movies have you watched more than three times?
어떤 콘서트의 맨 앞자리에 앉을 수 있다면, 어떤 콘서트를 선택하겠습니까?	If you could have front row seats to any concert, ever, what would you choose?
세계적인 수준의 재능을 가질 수 있다면, 어떤 악기를 선택하겠습니까?	If you could be a world-class talent on any instrument, which would it be?
추천하고 싶은 책은 무엇인가요? 이유는 무엇인가요?	What's one book you recommend and why?
현재 가장 흥분되는 일은 무엇인가요?	What in your life are you most excited about right now?
어린 시절에 꿈꾸던 직업은 무엇이었나요?	When you were a kid, what did you want to be when you grew up?
잠을 자지 않아도 된다면, 여분의 시간을 무엇에 사용하겠습니까?	If you didn't have to sleep, what would you do with the extra time?
언제 가장 살아있다고 느끼나요?	When do you feel most alive?
당신의 초능력은 무엇인가요?	What's your superpower?
현재 가장 어려운 문제는 무엇인가요?	What is the most challenging thing you're dealing with right now?
가장 자랑스러운 업적은 무엇인가요?	What is your proudest accomplishment?
어린 시절에 가졌던 비이성적인 두려움은 무엇인가요?	What irrational fears did you have as a child?
당신이 아는 가장 회복력이 강한 사람은 누구인가요? 무엇이 그들을 회복력 있게 만들었나요?	Who is the most resilient person you know? What makes them resilient?
내일 아침 일어났을 때 어떤 자질을 갖추고 싶나요?	If you could wake up tomorrow having gained any one quality, what would it be?
가까운 사람들은 당신을 어떻게 묘사할까요? 세 가지 단어로 표현해 보세요.	What are three words the people closest in your life would use to describe you?
받은 최고의 조언은 무엇인가요?	What's the best piece of advice you've ever been given?
의도는 행동보다 중요합니까, 덜 중요합니까?	Do intentions matter more or less than actions?
영적이라고 생각하나요? 그렇다면 어떤 방식으로요?	Do you identify as a spiritual person? If so, in why way?
어렸을 때 큰 문제에 빠졌던 경험을 설명해 보세요.	Describe a time you got into big trouble when you were younger.
지금 무엇에 감사하나요?	What are you grateful for right now?
어디에서 평화를 찾나요?	Where do you find peace?
보통 당연하게 여기는 것은 무엇인가요?	What do you normally take for granted?
지난해 가장 마법 같은 기억은 무엇인가요?	What is one magical memory from this past year?
자란 곳에서 독특한 점은 무엇인가요?	What is one thing that is unique about the place you grew up?
평생 웃음을 터뜨릴 기억은 무엇인가요?	What is a memory that will forever make you laugh out loud?
가장 기억에 남는 어린 시절 사고는 무엇인가요?	What is your most memorable childhood accident?
가장 기억에 남는 선생님은 누구인가요?	Who was your most memorable teacher?
모든 인간에게 하나의 선물을 준다면, 무엇을 선택하겠습니까?	If you could gift all humans one thing, what would it be?
무엇에 대해 미신을 믿나요?	Are you superstitious about anything?
이 그룹에서 리틀 리그 경기에서 심판에게 가장 소리를 지를 것 같은 사람은 누구인가요?	Who in this group is the most likely to yell at the ref in a little league game?
이 그룹에서 좀비 아포칼립스를 가장 잘 살아남을 것 같은 사람은 누구인가요?	Who in this group is most likely to make it through a zombie apocalypse?
이 그룹에서 불법 사업을 운영할 가능성이 가장 높은 사람은 누구인가요?	Who in this group is the most likely to own an illegal business?
이 그룹에서 공포 영화에서 가장 먼저 죽을 가능성이 가장 높은 사람은 누구인가요?	Who in this group is most likely to die first in a horror movie?
이 그룹에서 모두가 동의할 수 있는 것은 무엇인가요?	What's something that everyone in this group can agree on?
가장 끔찍한 데이트는 무엇이었나요?	What was the worst date you've been on?
가장 큰 두려움은 무엇인가요?	What is your greatest fear?
옆에 있는 사람이 범죄로 유죄 판결을 받았다면, 무엇 때문일까요?	If the person next to you were convicted of a crime, what would it be for?
완전히 잘못된 가정을 한 적이 있나요?	What assumption did you make that turned out to be completely wrong?
가장 무서운 영화는 무엇이었나요?	What is the scariest movie you've ever seen?
지역 뉴스에 나온다면, 어떤 이유일까요?	If you were featured on the local news, what would it most likely be for?
불법이기를 바라는 것은 무엇인가요?	What do you wish were illegal?
당신을 가장 잘 이해하는 사람은 누구인가요?	Who understands you better than anyone else?
미래 배우자를 선택할 수 있다면, 누구를 선택하겠습니까?	If you had to pick someone else to choose your future spouse, who would you pick?
현재 가장 스트레스를 받는 것은 무엇인가요?	What is something that is currently stressing you out?
어떤 것을 가르쳐야 한다면, 무엇을 가르치겠습니까?	If you had to teach a class on one thing, what would you teach?
절대 먹지 않을 음식은 무엇인가요?	What's a food that you refuse to eat?
가장 큰 애완동물 불만은 무엇인가요?	What are some of your biggest pet peeves?
무료로 쇼나 이벤트에 갈 수 있다면, 무엇을 원하겠습니까?	If you could get a ticket to any show or event for free, what would you want a ticket to?
가장 어리석은 도전은 무엇이었나요?	What was the dumbest thing you did because of a dare?
몇 번이고 봐도 질리지 않는 영화는 무엇인가요?	What movie could you watch over and over without ever getting tired of it?
직장(또는 학교)에서의 비공식적인 규칙은 무엇인가요?	What are some unwritten rules of where you work (or go to school)?
몇 마리의 닭이 악어를 죽일 수 있을까요?	How many chickens would it take to kill an alligator?
과거에 당연하게 여겼던 경험은 무엇인가요?	What past experience did you take for granted?
가장 과대평가된 연예인은 누구인가요?	What celebrity is overrated?
가장 기발한 광고는 무엇이었나요?	What is the most clever advertising you've seen?
가장 흥미로운 직장 동료나 학급 친구에 대해 이야기해 보세요. (좋거나 나쁘거나)	Tell the group about one of your most interesting coworkers or classmates. (good or bad)
지난달에 일어난 가장 웃긴 일은 무엇인가요?	What is one of the funniest things that happened to you in the last month?
어떤 리얼리티 TV 프로그램에 참여할 수 있다면, 어떤 것을 선택하겠습니까?	If you could go on any reality TV show, which would you go on?
새 이름을 선택해야 한다면, 무엇을 선택하겠습니까?	If you had to choose a new name for yourself, what would it be?
이 방에서 당신과 가장 비슷한 사람은 누구인가요?	Who in this room are you most similar to?
진실 두 가지와 거짓말 하나를 말해 보세요.	Share two truths and a lie.
어디를 가든 항상 가지고 다니는 것은 무엇인가요? (휴대폰 제외)	What is something that you bring with you everywhere you go? (Other than your phone)
실패한 적이 있나요? 중요한 교훈을 배웠나요?	What is something that you failed at? Did you learn any important lessons along the way?
첫 키스의 이야기를 들려주세요.	Tell the story of your first kiss.
좋은 차를 가지는 것과 좋은 집을 가지는 것 중 어떤 것이 더 중요합니까? 이유는 무엇인가요?	Which is more important to you, having a great car or a great house? Why?
어린 시절의 필수 영화는 무엇이었나요?	What was one of your go-to movies as a child?
따뜻한 음식과 차가운 음식 중 하나를 영원히 먹지 못한다면, 어떤 것을 선택하겠습니까?	Would you rather never be able to eat warm food or cold food?
가장 웃긴 아빠 농담은 무엇인가요?	What is one of the funniest dad jokes that you know?
다른 사람들보다 더 많이 아는 주제는 무엇인가요?	What topics are you more knowledgeable about than most people?
사람들이 역겨워할 수도 있는 음식을 좋아하나요?	What food do you love that a lot of people might find gross?
현재 인생에서 가장 좋은 것은 무엇인가요?	What's the best thing you have going on in your life at the moment?
아주 흔한 일이지만 한 번도 해보지 않은 것은 무엇인가요?	What incredibly common thing have you never done?
가장 순진했던 순간은 무엇이었나요?	What was one of your most gullible moments?
듣는 것이 부끄러운 밴드는 무엇인가요?	What band are you embarrassed to admit that you listen to?
가장 무작위적인 사실은 무엇인가요?	What's one of the most random facts that you know?
가장 흥미로운 친척은 누구인가요?	Who is one of your most interesting relatives?
주변 사람들이 모두 맡을 수 있는 냄새를 항상 맡을 수 있다면, 어떤 냄새를 선택하겠습니까?	If you were always surrounded by one scent that you and everyone around you could smell, what would it be?
가장 어려웠던 일은 무엇인가요?	What is one of the hardest things you've ever done?
가장 영향을 준 책은 무엇인가요?	What was one of the most influential books you've ever read?
"완전히 ""정신을 잃은"" 마지막 순간은 언제였나요?"	"When was the last time that you completely ""lost it""?"
	What is the coolest app you have on your phone?
	If you could put a new word in the dictionary, what would it be and what would be the definition?
	What was one of the funniest arguments that you've been in?
	What's the best way you or someone you know has gotten out of trouble?
	What would be the first few things you would try if you found out you could never be injured?
	Who was your most interesting teacher? (Good or bad)
	Pull out your phone and share your most used app from last week.
	Pull out your phone and read your last text out loud to the group.
	What is something funny you think about from time to time?
	What's a song that gets you motivated?
당신이 가지고 있는 웃긴 습관은 무엇인가요?	What is a funny habit that you have?
어머니가 듣고 창피해하실 만한 일을 한 적이 있나요?	What's one thing your mom would be embarrassed to hear you've done?
영화에서 당신을 연기할 연예인은 누구인가요?	Which celebrity would play you in a movie?
배우고 싶은 세계 문화는 무엇인가요?	Which world culture would you like to learn more about?
"사람들이 삶에서 ""더 높은 소명""을 가지고 있다고 믿나요?"	"Do you believe people have a ""higher calling"" in life?"
최근에 배운 것 중 자랑스러운 것은 무엇인가요?	What's something that you are proud to have learned lately?
삶에서 가장 큰 목적을 어디에서 찾나요?	Where do you find the most purpose in your life?
만난 적은 없지만 아는 것 같은 사람은 누구인가요?	Who do you feel like you know even though you've never met them?
이성에 대해 가장 혼란스러운 점은 무엇인가요?	What about the opposite sex confuses you the most?
가장 오글거리는 단어는 무엇인가요?	What are some of the cringiest words?
당신이 아는 가장 똑똑한 사람들은 누구인가요?	Who are some of the most intelligent people you know?
당신의 단골 레스토랑은 어디인가요?	What are some of your go-to restaurants?
과거 또는 현재의 음악 그룹 중 하나에 가입할 수 있다면 어디에 가입하겠습니까?	If you could join one music group, past or present, which would you join?
이 방에서 가장 다른 두 사람은 누구인가요?	Which two people in this room are the most different?
당신이 잘할 것 같지 않은 직업은 무엇인가요?	What is a job you think you'd be terrible at?
이 방에서 가장 비슷한 두 사람은 누구인가요?	Which two people in this room are the most similar?
이 방의 대부분의 사람들보다 운전을 더 잘한다고 생각하나요 아니면 더 못한다고 생각하나요?	Do you think you're a better or worse driver than most people in this room?
누군가에게 가장 잘 속인 장난은 무엇인가요?	What's the best prank you've ever played on someone?
당신 자신을 세 단어로 표현한다면 무엇인가요?	How would you describe yourself in three words?
법에 걸리지 않고 불법적인 일을 할 수 있다면 무엇을 하겠습니까?	If you could do anything illegal without getting in trouble, what would it be?
당신이 가장 큰 곤경에 처한 적은 언제인가요?	What's the most trouble you've ever been in?
결혼하기 전에 데이트하는 적절한 기간은 얼마나 되나요?	What is the right amount of time to date someone before getting married?
가장 좋아하는 cheesy한 픽업 라인은 무엇인가요?	What's your favorite cheesy pick-up line?
가장 웃긴 부상 경험은 무엇인가요?	What's the funniest way that you have been injured?
당신이 말을 잘못한 순간은 언제인가요?	When was a time that you stuck your foot in your mouth?
가장 웃긴 버릇은 무엇인가요?	What is your funniest quirk?
당신은 사람의 성격을 잘 판단하는 편인가요? 전혀 잘못 판단한 적이 있나요?	Would you consider yourself a good judge of character? Have you ever gotten someone completely wrong?
누군가를 감동시키기 위해 한 가장 웃긴 일은 무엇인가요?	What is the funniest thing you have done to impress someone?
당신이 한 가장 큰 거짓말은 무엇인가요?	What is the biggest lie you've ever told?
수면 없이 가장 오래 버틴 시간은 얼마나 되나요? 왜 그렇게 되었나요?	What's the longest you've gone without sleep, and why?
직장에서 저지른 가장 큰 실수는 무엇인가요?	What is the biggest mistake you've made at work?
부모님이나 보호자로부터 받은 이상한 버릇이나 태도는 무엇인가요?	What weird quirks or mannerisms did you pick up from your parents or guardians?
다시 돌아왔으면 하는 패션 트렌드는 무엇인가요?	What fashion trend should come back?
당신의 영혼 동물은 무엇인가요?	What is your spirit animal?
일하고 싶은 다른 회사들은 어떤 회사들인가요? 왜요?	What are some different companies that you would like to work for? Why?
만난 적 있는 가장 유명한 사람은 누구인가요?	Who is the most famous person you've ever met?
인생에 리와인드 또는 일시정지 버튼을 가지고 싶습니까?	Would you rather have a rewind or a pause button for your life?
다른 사람들은 신경 쓰지 않지만 당신을 정말 짜증나게 하는 것은 무엇인가요?	What is something that really annoys you but doesn't bother most people?
당신의 별명은 무엇인가요?	What are some of your nicknames?
가장 좋은 룸메이트 이야기를 들려주세요.	Tell one of your best roommate stories.
누군가의 재능을 훔칠 수 있다면 누구의 재능을 훔치겠습니까?	If you could steal a talent from someone, what talent would you steal and from whom?
항상 10분 늦게 도착하는 것과 30분 일찍 도착하는 것 중 무엇을 선택하겠습니까?	Would you rather always be 10 minutes late or 30 minutes early?
생일에 어딘가로 가는 것과 무언가를 받는 것 중 무엇을 선택하겠습니까?	For your birthday, would you rather go somewhere or get something?
가장 미친 짓을 한 적은 언제인가요?	What is one of the craziest things you've ever done?
세월이 흐르면서 당신은 어떻게 변했나요?	How do you think you've changed through the years?
제가 차라면 어떤 차일까요? (그룹이 당신에 대해 답할 것입니다)	If I were a car, what car would I be? (The group will answer this about you)
죽을 뻔한 경험은 언제였나요?	When was the closest you've ever come to dying?
제가 신발이라면 어떤 신발일까요? (그룹이 당신에 대해 답할 것입니다)	If I were a pair of shoes, what kind would I be? (The group will answer this about you)
이 방의 누군가에 대한 첫인상은 어땠나요?	What was your first impression of someone in this room?
가장 캐릭터에 어울리지 않는 일을 한 적이 있나요?	What's the most out-of-character thing you've ever done?
가장 큰 후회는 무엇인가요?	What is your biggest regret?
이 방에서 가장 좋은 대통령이 될 사람은 누구인가요? (당신 자신을 선택할 수 없습니다)	Who in this room would make the best president? (You can't choose yourself)
마지막으로 울었던 때는 언제였나요?	When was the last time you cried?
마지막으로 정말 화가 났던 때는 언제였나요?	When was the last time you were really angry?
가장 무서웠던 순간은 무엇인가요?	What was one of the scariest moments of your life?
가장 어색했던 순간은 무엇인가요?	What was one of the most awkward moments of your life?
여기에서 자신의 행사에 두 시간 늦게 올 가능성이 가장 높은 사람은 누구인가요?	Who here is the most likely to be two hours late to their own event?
여기에서 정치적으로 가장 올바른 사람은 누구인가요? 가장 올바르지 않은 사람은 누구인가요?	Who here is the most politically correct? Who is the least politically correct?
완전히 잘못 판단했던 사람은 누구인가요?	Who is someone that you completely misjudged?
여기에서 고아원을 열 가능성이 가장 높은 사람은 누구인가요?	Who here is most likely to open an orphanage?
역사 속 한 사건을 목격할 수 있다면 무엇을 선택하겠습니까?	If you could witness one event in history, what would it be?
가장 과대평가된 레스토랑은 무엇인가요?	What is the most overrated restaurant?
새로운 삶에서 가장 부유한 사람이 될 수 있다면 인생을 다시 시작하시겠습니까?	Would you start your life all over again if, in your new life, you would be the richest person alive?
이성이 되는 것에 대해 가장 어려운 점은 무엇인가요?	What would be the most challenging thing about being the opposite sex?
10년 전 알았으면 좋았을 것은 무엇인가요?	What is something you wish you would have known 10 years ago?
여기에서 인플루언서가 될 가능성이 가장 높은 사람은 누구인가요?	Who here is most likely to become an influencer?
당신에 대한 고정관념 중 사실인 것은 무엇인가요?	What stereotype about you is true?
오리 크기의 코끼리 50마리와 코끼리 크기의 오리 한 마리와 싸우는 것 중 무엇을 선택하겠습니까?	Would you rather fight 50 duck-sized elephants or one elephant-sized duck?
이 방의 각 사람에게 닮은 연예인을 선택하십시오.	Pick a celebrity look-alike for each person in the room.
올림픽에서 내일 경기에 출전해야 한다면 어떤 종목에서 이길 수 있을 것 같습니까?	If you had to compete in the Olympics tomorrow, what event do you think you could win?
이 방의 각 사람을 한 단어로 설명하십시오.	Pick one word to describe each person in the room.
토끼 크기의 동물 중 가장 귀여운 것은 무엇인가요?	What animal would be the cutest if it were the size of a rabbit?
역사 속 누구에게 질문을 할 수 있다면 누구를 선택하겠습니까? 어떤 질문을 하겠습니까?	If you could ask a question to anyone in history, who would you choose, and what question would you ask?
세계의 누구와 24시간 동안 몸을 바꿀 수 있다면 누구를 선택하겠습니까? 무엇을 하겠습니까?	If you could swap bodies with any person in the world for 24 hours, who would you choose, and what would you do?
화성에 무료로 갈 수 있다면 가겠습니까? 왜 또는 왜 아닙니까?	If you could go to Mars for free, would you go? Why or why not?
어떤 미스터리의 진실을 알고 싶습니까?	If you could know the truth about any mystery, which would it be?
당신이 좋아한다고 인정하기 부끄러운 영화는 무엇인가요?	What's a movie that you're embarrassed to admit you like?
현 대통령보다 더 잘할 수 있다고 생각하십니까? 왜 또는 왜 아닙니까?	Do you think you could do a better job than the current president? Why or why not?
이 방의 누군가와 인생을 바꿔야 한다면 누구와 바꾸겠습니까? 왜요?	If you had to trade lives with someone in this room, who would you trade with? Why?
평생 하나의 노래만 들을 수 있다면 무엇을 선택하겠습니까?	If you could only listen to one song for the rest of your life, what would it be?
어떤 음모 이론을 믿나요?	Do you believe in any conspiracy theories?
다음 중 하나 이상을 믿습니까: 유령, 외계인, 빅풋?	Do you believe in one or more of the following: Ghosts, aliens, Bigfoot?
전혀 잠을 자지 않아도 된다면 매일 밤 추가 시간으로 무엇을 하겠습니까?	If you didn't need to sleep at all, what would you do with all the extra time each night?
과거로 돌아가서 논쟁에서 무조건 이길 수 있다면 어떤 논쟁을 선택하고 왜 그 논쟁을 선택하겠습니까?	If you could go back in time and unquestionably win any argument you've had, what argument would you choose to win and why?
어떤 사회 규범이 어리석다고 생각합니까?	What social norm do you think is stupid?
당신이 가진 무작위 공포는 무엇인가요?	What is a random fear that you have?
두 동물의 소리를 바꿀 수 있다면 어떤 두 동물을 선택하겠습니까?	If you could switch the sounds that two animals make, which two would you choose?
어떤 이상한 것을 사회적으로 받아들일 수 있게 만들겠습니까?	What weird thing would you make socially acceptable if you could?
어떤 회사의 CEO가 되고 싶습니까?	If you could be the CEO of any company, what company would you choose?
죽은 사람 중 5년 더 살 수 있게 만들 사람은 누구인가요?	Who would you bring back from the dead to live for 5 more years if you could?
다른 사람의 집에서 본 가장 이상한 것은 무엇인가요?	What was the weirdest thing you saw in someone else's home?
당신은 얼마나 위험을 감수하는 사람인가요?	How much of a risk-taker are you?
어떤 교훈을 어려운 방법으로 배웠습니까?	What lesson did you learn the hard way?
작은 불편함이 당신을 화나게 합니까?	What minor inconvenience enrages you?
나쁜 룸메이트나 집 손님을 가진 적이 있습니까?	Have you ever had a bad roommate or house guest?
당신이 해낸 가장 창의적인 일은 무엇인가요?	What is the most creative feat you've performed?
계획하는 것과 즉흥적인 것 중 어느 것을 선호하십니까?	Do you prefer planning things out or being spontaneous?
집에서 가장 좋아하는 방은 어디인가요?	Which room in your home is your favorite?
당신의 직업과 다른 직업 중 어떤 직업이 관심이 있습니까?	What profession (different from your own) interests you?
입양되었다면 생물학적 부모를 찾고 싶습니까? 입양을 고려한 적이 있습니까?	If you were adopted, would you want to find your biological parents? Have you ever considered adopting?
아이였을 때의 어떤 점이 가장 그리운가요?	What about being a kid do you miss the most?
사랑하는 작은 마을은 어디인가요?	What small town do you love?
당신은 머리로 더 많이 행동하나요 아니면 마음으로 더 많이 행동하나요?	Do you operate more by your head or your heart?
세상이 전반적으로 더 좋아지고 있다고 생각하십니까 아니면 더 나빠지고 있다고 생각하십니까?	Do you think the world is getting better or worse in general?
최근에 당신의 삶에서 빠진 것은 무엇인가요?	What is missing from your life lately?
가장 어린 시절의 기억 중 하나는 무엇인가요?	What is one of your earliest memories?
사회에 기여하는 것이 중요하다고 생각합니까?	Do you think it's important to contribute to society?
무엇을 수집합니까?	Do you collect anything?
세계의 지배자라면 어떤 미친 짓을 하겠습니까?	If you were the ruler of the world, what crazy stuff would you do?
가장 좋아하는 장소는 어디인가요?	Where is your favorite spot to hang out?
다른 사람들과 시간을 보내는 것에서 가장 즐기는 것은 무엇인가요?	What do you enjoy most about spending time with other people?
당신의 가장 친한 친구에 대해 무엇을 사랑합니까?	What do you love about your best friend?
가장 좋아하는 냄새는 무엇인가요?	What is your favorite smell?
너무 두려워서 시도하지 않은 기회는 무엇인가요?	What is an opportunity you were too afraid to take?
어렸을 때 용돈을 받았나요? 아이들에게 용돈을 주는 것이 좋다고 생각하나요?	Did you have an allowance as a kid? Do you think kids should have allowances?
감사한 것은 무엇인가요?	What's something you are grateful for?
어렸을 때 자주 갔던 장소는 어디인가요?	What place do you remember going to a lot as a kid?
사랑하지만 짜증나는 것은 무엇인가요?	What's something you love that can be frustrating?
비 오는 오후를 보내는 가장 좋은 방법은 무엇인가요?	What's the best way to spend a rainy afternoon?
과거, 현재, 미래 중 어떤 것에 대해 더 많이 생각하십니까?	Do you spend more time thinking about the past, the present, or the future?
저녁을 함께하고 싶은 유명인 또는 영향력 있는 인물은 누구입니까?	Which celebrity or influential figure would you love to have dinner with?
내일 깨어났는데 다른 사람은 모두 사라졌다면 무엇을 하겠습니까?\	What would you do if you woke up tomorrow and everyone else was gone?
가장 아름다운 장소는 어디였나요?	What was the most beautiful place you've been to?
배를 가지고 있다면 이름을 무엇으로 짓겠습니까?	What would you name your boat if you had one?
비이성적인 두려움은 무엇인가요?	What irrational fear(s) do you have?
어렸을 때 믿었던 가장 이상한 것은 무엇인가요?	What's the weirdest thing you believed as a kid?
가진 별명은 무엇인가요? 사람들에게 별명을 지어주나요?	What nicknames have you had? Do you give people nicknames?
어린 시절의 정의하는 냄새는 무엇인가요?	If your childhood had a defining smell, what would it be?
10점 만점에 10점을 줄 수 있는 것은 무엇인가요?	What would you rate 10/10?
친구가 소개해 준 멋진 것은 무엇인가요?	What awesome thing were you introduced to by a friend?
당신은 음악적 재능이 있습니까? 음악이 당신의 삶에서 얼마나 중요한가요?	Are you musically talented? How important is music in your life?
가장 이상한 꿈은 무엇이었나요? 반복되거나 명료한 꿈을 꾸나요?	What's the strangest dream you've had? Do you ever have recurring or lucid dreams?
묘비에 웃긴 것을 적는다면 무엇을 적겠습니까?	If you were to put something silly on your tombstone, what would it be?
가장 당황스러운 경험은 무엇이었나요?	What was one of the most embarrassing things that happened to you?
$1,000 상품권을 받기 가장 싫은 가게는 어디인가요?	Which store would be the worst to have a $1,000 gift card for?
개인 깃발을 가지고 있다면 무엇이 그려져 있을까요?	If you had a personal flag, what would be on it?
향후 10년 동안 가장 기대되는 것은 무엇인가요?	What are you most looking forward to in the next 10 years?
가장 부적절한 시기에 웃음을 멈출 수 없었던 적은 언제인가요?	When was the most inappropriate time you couldn't stop laughing?
가장 이상한 대화는 무엇이었나요?	What was one of the weirdest conversations you've ever had?
마지막 식사로 무엇을 선택하시겠습니까?	What would you choose for your last meal?
변하지 않기를 바라는 것은 무엇인가요?	What do you hope will never change?
당신은 정직한가요 아니면 친절한가요?	Are you most often honest or kind?
부모님의 어떤 말이 수년간 마음에 남아 있습니까?	What comment from a parent has stuck with you for years?
한 달 동안 독방에 갇혀 있다면 어떻게 정신을 유지하려고 노력하시겠습니까?	If you were forced into a month of solitary confinement, how would you try to stay sane?
유명해지고 싶습니까?	Would you like to be famous?
가장 기억에 남는 신체 기능은 무엇인가요?	What's the most memorable bodily function you've had?
가족에 대해 사랑하는 것은 무엇인가요?	What do you love about your family?
독서를 좋아합니까? 그렇다면 무엇을 읽는 것을 좋아하나요?	Do you enjoy reading? If so, what do you like to read?
우리가 처음 만났을 때 저에 대해 어떻게 생각했나요?	What did you think of me when we first met?
증거가 거의 없거나 전혀 없는데도 믿는 것은 무엇인가요?	What do you believe in despite having little or no proof?
즉시 마스터하고 싶은 악기는 무엇인가요?	Which musical instrument do you wish you could master instantly?
다른 사람들로부터 조언을 받는 것을 좋아합니까? 그렇다면 누구에게 조언을 구하나요?	Do you like getting advice from other people? If so, who do you go to for advice?
인류가 지구 외의 행성에서 살게 될 것이라고 생각하나요?	Do you think humans will ever live on a planet other than Earth?
가장 좋아하는 애니메이션 영화는 무엇인가요?	What's your favorite animated movie?
가장 최악의 패션 트렌드는 무엇인가요?	What is the worst fashion trend ever?
어떤 동물의 생활 방식이 당신의 생활 방식과 가장 비슷한가요?	What animal's lifestyle most closely resembles your own?
가장 재미있는 약물 관련 이야기는 무엇인가요?	What's your funniest substance-related story?
삶을 어떻게 바라봅니까?	How do you keep life in perspective?
사람들이 듣고 놀랄 만한 사람이나 그룹은 누구인가요?	What person or group are you a fan of that people would be surprised to hear?
"가족 중에 ""캐릭터""로 묘사할 사람은 누구인가요?"	"Who in your family would you describe as a ""character""?"
여행을 떠올리게 하는 음악은 무엇인가요?	What music makes you think of traveling?
모든 사람들이 한 번쯤 해봐야 한다고 생각하는 것은 무엇인가요?	What's something you believe everyone should do at least once?
어렸을 때 친구 집에서 자면서 기억나는 것은 무엇인가요?	What do you remember about sleeping over at a friend's house when you were young?
이름을 바꿔야 한다면 무엇으로 바꾸겠습니까?	If you had to change your name, what would you change it to?
최근에 놀란 것은 무엇인가요?	What's something that surprised you recently?
나이를 느끼게 하는 것은 무엇인가요?	What makes you feel old?
최근에 가장 큰 행복을 주는 것은 무엇인가요?	What is bringing you the most happiness lately?
가장 용감한 사람의 행동은 무엇이었나요?	What's the bravest thing you've seen someone do?
향후 몇 개월간의 계획은 무엇인가요?	What are your plans for the next few months?
가장 좋아하는 욕설은 무엇인가요? 가장 공격적인 욕설은 무엇이라고 생각하나요?	Which curse word is your favorite? Which one do you think is the most offensive?
과거로 돌아가서 되돌리고 싶은 것은 무엇인가요?	If you could go back in time, what's something you would undo?
지난 주에 배운 것은 무엇인가요?	What's something you've learned in the last week?
가장 자주 추는 춤은 무엇인가요? 춤을 잘 추시나요?	What's your go-to dance move? Are you a good dancer?
첫 키스에 대한 기억은 무엇인가요?	What do you remember about your first kiss?
우리의 우정 초기에 기억에 남는 추억은 무엇인가요?	What is one of your favorite memories from early in our friendship?
가장 많이 들은 앨범이나 노래는 무엇인가요?	What album or song have you listened to more than any other?
가장 좋아하는 운동 방법은 무엇인가요?	What's your favorite way to exercise?
첫 직업을 어떻게 구했나요? 얼마나 오래 일했나요?	How did you get your first job? How long did you work there?
뉴스에 나와야 한다면 어떤 이야기를 원하시겠습니까?	If you were to be on the news for something, what would you want the story to be about?
살고 싶은 책이나 영화 세계는 무엇인가요?	What book or movie universe would you choose to live in if you could?
도박이나 기회를 잡아 성공했던 적은 언제인가요?	When did you take a chance or gamble that paid off?
가장 좋아하는 이모나 삼촌은 누구인가요?	Who is your favorite aunt or uncle?
가장 좋아하는 생애 시기는 언제인가요?	Which period of your life do you look back on fondly?
어렸을 때 부모님께 혼난 기억은 무엇인가요?	Do you remember getting in trouble with your parents for anything you did as a kid?
모든 사람이 바보처럼 보이는 것은 무엇인가요?	What's something that everyone looks stupid doing?
더 알고 싶은 주제는 무엇인가요?	What subject would you like to learn more about?
다른 영화는 어떤 느낌을 줄 수 없는 영화는 무엇인가요?	What movie makes you feel something no other can?
어렸을 때 집착했던 것은 무엇인가요?	What were you obsessed with as a child?
당신은 얼마나 내성적입니까? 왜 그렇게 생각하나요?	How shy are you? Why do you think that is?
몇 시간이고 행복하게 할 수 있는 활동은 무엇인가요?	What activity could you happily do for hours and hours?
부모님이 당신의 이름을 어떻게 지었나요?	How did your parents decide what to name you?
최고의 것을 얻기 위해 더 많은 돈을 쓸 만한 것은 무엇인가요?	What's worth spending more money on to get the best?
좀비 아포칼립스에서 얼마나 유용할 것 같습니까?	How useful would you be in a zombie apocalypse?
사기를 당한 적이 있습니까? 그렇다면 무슨 일이 있었나요? 아니라면 어떻게 피하나요?	Have you fallen for a scam before? If so, what happened? If not, how do you avoid them?
애완동물을 몇 마리 키웠습니까? 이름은 무엇이었나요?	How many pets have you had, and what were their names?
지난 주에 당신을 짜증나게 한 일은 무엇인가요?	What happened in the last week that annoyed you?
당신이 사는 곳에 대해 좋아하는 점은 무엇인가요?	What do you like about where you live?
당신의 성장 배경에서 독특했던 것은 무엇인가요?	What do you think was unique about your upbringing?
첫 번째 연예인 짝사랑은 누구였나요?	Who was your first celebrity crush?
가장 좋아하는 공룡은 무엇인가요? 가장 좋아하는 동물은 무엇인가요? 왜요?	What's your favorite dinosaur? WHat's your favorite animal? Why?
더 많은 시간을 내고 싶은 것은 무엇인가요?	What do you want to make more time for?
깨진 가장 비싼 것은 무엇인가요?	What's the most expensive thing you've broken?
최근에 당신을 성장하게 한 것은 무엇인가요?	What has forced you to grow recently?
어떻게 휴식을 취하는 것을 좋아하나요?	How do you like to relax?
가장 좋은 이야기가 담긴 흉터는 무엇인가요?	Which of your scars has the best story behind it?
미래에 현재 생활 방식에 대해 그리워할 것은 무엇인가요?	What might you miss in the future about your current lifestyle?
어린 시절에 배운 인생 교훈 중 오늘날 당신에게 영향을 미치는 것은 무엇인가요?	What life lesson did you learn as a kid that impacts who you are today?
부정적인 결과가 없다면 누구를 한 번 때리고 싶습니까?	Who would you enjoy slapping across the face if there were no negative consequences?
$20,000,000 개발 상금을 제안하고 싶은 발명품은 무엇인가요?	What invention would you offer a $20,000,000 development prize for if you had the money?
최악의 도로 여행은 무엇이었나요? 무슨 일이 있었나요?	What was your worst road trip? What happened?
아주 빨리 배워야 했던 적은 언제인가요?	When did you have to learn very quickly?
몸이 늙지 않는다면 영원히 살고 싶습니까?	Would you want to live forever if your body didn't get old?
미래 사회가 우리가 지금 살고 있는 방식에 대해 흥미롭거나 재미있다고 생각할 것은 무엇인가요?	What do you think future societies will find interesting or funny about how we live now?
여행 중 배운 것은 무엇인가요?	What's something you learned while traveling?
가장 좋아하는 작가나 영화 감독은 누구인가요? 그가 당신의 가장 좋아하는 이유는 무엇인가요?	Who's your favorite author or film director? What makes him or her your favorite?
당신의 경력 선택에 가장 큰 영향을 미친 사람은 누구인가요?	Who had the biggest impact on your career choice?
가장 많이 생각하는 것은 무엇인가요?	What do you spend the most time thinking about?
괴롭힘을 당한 적이 있나요?	Have you ever stood up to a bully?
삶에서 원하는 것은 무엇인가요?	What do you want from life?
가장 못생긴 의류 품목은 무엇인가요?	What's the ugliest item of clothing you've ever worn or owned?
긴 여행 후 집에 돌아오는 것에 대해 가장 좋아하는 점은 무엇인가요?	What's your favorite thing about coming home after a long trip?
다른 사람에게 깊이 감사했던 순간은 언제인가요?	When did you feel deeply appreciated by someone else?
가장 좋아하는 예술가(배우, 작가, 음악가, 화가 등)는 누구인가요?	Who is your all-time favorite artist (actor, author, musician, painter, etc.)?
정기적으로 너무 많은 돈을 쓰는 것은 무엇인가요?	What do you regularly spend too much money on?
어렸을 때 형제자매(또는 외동이라면 사촌)와 시간을 어떻게 보냈나요?	How did you spend time with your siblings (or cousins if you are an only child) when you were little?
언젠가 참석하고 싶은 행사는 무엇인가요?	What event would you like to attend one day?
열정이 있습니까? 있다면 무엇입니까? 없다면 열정이 있기를 바라나요?	Do you have a passion? If so, what? If not, do you wish you had one?
당신의 삶에서 가장 중요한 숫자는 무엇인가요?	What's the most significant number in your life?
가장 인상적인 운동 성과는 무엇인가요?	What is the most impressive athletic feat you've performed?
개인 셰프나 가정부 중 누구를 선택하시겠습니까?	Would you rather have a personal chef or a maid?
어린 시절 가장 좋아했던 음식은 무엇인가요?	What was your favorite childhood meal?
당신의 삶이 생각했던 것과 어떻게 다른가요?	How is your life different from how you thought it would be?
가장 싫어하는 집안일은 무엇인가요?	What's the worst chore?
가장 신비로운 사람은 누구인가요?	Who is the most mysterious person you know?
불확실성을 잘 다루십니까?	Are you good at dealing with uncertainty?
은행에 $10,000,000이 있다면 시간을 어떻게 보내겠습니까?	How would you spend your time if you had $10,000,000 in the bank?
첫인상은 얼마나 중요한가요? 첫인상을 잘못 만든 적이 있습니까?	How important are first impressions? When did you make a bad first impression?
없앨 수 있다면 어떤 휴일을 없애겠습니까?	Which holiday would you get rid of if you could?
우주로 가는 것과 바다 밑으로 가는 것 중 무엇을 선택하시겠습니까?	Would you rather go to space or the bottom of the ocean?
야드 세일에서 산 최고의 물건은 무엇인가요?	What was the best thing you bought at a yard sale?
고향에서 가장 좋아하는 지역 행사는 무엇인가요?	What's your favorite local event in your hometown?
야외 활동을 즐기십니까? 캠핑을 얼마나 많이 해보셨나요?	Do you enjoy the outdoors? How much camping have you done?
나이가 들면서 더 두려워지는 것은 무엇인가요?	What do you get more afraid of as you get older?
경고 라벨을 가지고 있다면 무엇을 쓸 것인가요?	If you had a warning label, what would it say?
종말을 생존하기 위해 함께 팀을 이루고 싶은 실제로 아는 두 사람은 누구인가요?	Which 2 people (that you actually know) would team up with to try to survive an apocalypse?
많은 시간을 낭비하는 것은 무엇인가요?	What do you waste a lot of time on?
가장 특이한 관심사는 무엇인가요?	What's the most obscure subject you're interested in?
학교에서 가장 나빴던 날은 무엇인가요?	What was the worst day of school you ever had?
한 번 했던 직업에 대해 그리운 점은 무엇인가요?	What do you miss about a job you once had?
가장 위험한 일은 무엇이었나요?	What was the most dangerous thing you've done?
학교에서 가장 좋아했던 과목은 무엇인가요? 가장 싫어했던 과목은 무엇인가요?	What was your favorite subject in school? What was your least favorite?
어머니에 대한 최고의 기억은 무엇인가요?	What's one of your best memories of your mom?
당신이 좋아하는 사람 앞에서 가장 당황스러운 일은 무엇이었나요?	What was one of the most embarrassing things you did in front of someone you had a crush on?
이 세상에는 두 종류의 사람이 있습니다. 그것은 무엇입니까?	There are two types of people in this world. What are they?
극복한 두려움은 무엇인가요?	What fear have you overcome?
더 이상 환영받지 못하는 곳은 어디인가요? 어떻게 알았습니까?	Where are you no longer welcome? How do you know?
당신이 잘할 것 같지 않은 직업은 무엇인가요?	What job would you be terrible at?
첫 연인을 어떻게 만났나요?	How did you meet your first romantic interest?
한 분야에서 최고의 전문가가 될 수 있다면 어떤 분야를 선택하시겠습니까?	If you could become the number one expert in a field, which field would you choose?
고등학교 시절 당신은 어떤 사람이었나요?	What were you like during high school?
가장 인내심이 많은 사람은 누구인가요? 더 인내심이 많기를 바라나요?	Who is the most patient person you know? Do you wish you were more patient?
가장 멀리 간 곳은 어디인가요?	What was the furthest away from home you've ever been?
사람들이 당신의 신뢰를 얻기 위해 해야 할 일은 무엇인가요?	What do people need to do to gain your trust?
청결에 대한 애착이 있습니까?	Do you have any cleanliness pet peeves?
당신에게 가장 중요한 게임이나 스포츠는 무엇인가요?	What game or sport matters the most to you?
당신을 가장 잘 설명하는 단어는 무엇인가요?	What single word best describes you?
좋은 일을 하도록 동기를 부여하는 것은 무엇인가요?	What motivates you to do good work?
가장 무서운 영화 괴물은 무엇인가요?	What movie monster scares you the most?
어떤 언어를 배우고 싶나요?	Which other language would you like to know?
이상적인 여행 동반자는 누구인가요? 당신이 여행하기 좋은 사람인 이유는 무엇인가요?	Who is your ideal travel companion? What makes you a good person to travel with?
새로운 사람을 만나는 가장 좋아하는 방법은 무엇인가요?	What's your favorite way to meet new people?
가족이 반대한 선택은 무엇인가요?	What choice did you make that your family disapproved of?
당신의 죄책감은 무엇인가요?	What is your guilty pleasure?
긴장했지만 실제로 잘 풀린 것은 무엇인가요?	What were you nervous about but actually turned out well?
가장 좋아하는 요일은 무엇인가요? 가장 좋아하는 달은 무엇인가요?	What's your favorite day of the week? What's your favorite month of the year?
절대 먹지 않을 것은 무엇인가요?	What is something you absolutely wouldn't eat?
가장 좋아하는 꽃이나 식물은 무엇인가요?	What's your favorite flower or plant?
모든 전자 제품이 영원히 작동하지 않는다면 어떻게 다르게 살겠습니까?	How would you live differently if all electronics stopped working forever?
하나의 법을 통과시킬 수 있다면 무엇을 통과시키겠습니까?	If you could get one law passed, what would it be?
가장 싫었던 도시나 마을은 어디인가요?	What's the worst city or town you've ever been in?
시도해보고 싶은 허구의 음식은 무엇인가요?	What is one fictional food you'd like to try?
할아버지와 함께한 최고의 기억은 무엇인가요?	What's one of your best memories of one of your grandfathers?
다른 나라로 이사할 수 있다면 어디로 가겠습니까?	If you could move to any other country, where would you go?
당신의 초등학교 시절 가장 생생한 기억은 무엇인가요?	What's one of your most vivid memories from elementary school?
가장 싫어하는 영화 장르는 무엇인가요?	What is your least favorite movie genre?
바라던 일이 있었는데, 막상 일어나고 나니 싫었던 일이 있나요?	Is there something you wanted to happen but disliked once it did?
누군가에게 말하기 불편했던 일이 있었나요?	What's an uncomfortable thing you had to tell someone?
당신이 알고 있는 가장 이른 조상은 누구입니까?	Who is your earliest ancestor that you know something about?
지금 당신의 삶에서 가장 큰 기회는 무엇인가요?	What's your biggest opportunity in your life right now?
어렸을 때 부모님이 여전히 이야기하는 것은 무엇인가요?	What did you do as a child that your parents still talk about?
행복은 얼마나 중요한가요? 더 중요한 것이 있나요?	How important is happiness? Are some things even more important?
가장 소중한 소유물은 무엇인가요? 왜 그것이 중요한가요?	What is your most treasured possession? Why is it important to you?
가장 자랑스러운 성취는 무엇인가요?	What is your proudest accomplishment?
가장 초현실적이거나 설명할 수 없는 경험은 무엇인가요?	What's the most surreal or unexplainable thing you've experienced?
가장 맛있었던 식사는 무엇인가요?	What was the best meal you've ever had?
당신이 좋아하는 나라의 한 가지는 무엇인가요?	What's one thing you like about your country?
사람들에 대해 가장 놀라운 점은 무엇인가요?	What surprises you the most about people?
사업을 시작한다면 어떤 종류의 사업을 하겠습니까?	If you were going to start a business, what kind would it be?
여행에서 가장 즐기는 점은 무엇인가요? 여행을 좋아하지 않는다면 그 이유는 무엇인가요?	What do you enjoy most about traveling? Or if you don't like traveling, why not?
당신의 꿈의 집이 특별한 점은 무엇인가요?	What's special about your dream home?
초등학교에서 가장 좋아했던 것은 무엇인가요?	What was your favorite thing about elementary school?
세상에서 가장 나쁜 노래는 무엇인가요?	What's the worst song in the world?
기억에 남는 선물은 무엇인가요?	What memorable gift have you received or given?
첫 차에 대해 좋아했던 점 하나는 무엇인가요?	What was one thing you liked about your first car?
당신이 까다롭게 구는 것은 무엇인가요?	What are you picky about?
가장 인상 깊었던 여행 경험은 무엇인가요?	What trip or travel experience has most affected your life so far?
삶을 가장 풍부하게 사는 사람은 누구인가요?	Who do you know who lives life to the fullest?
돈이 주어진다면 어떤 종류의 박물관을 열겠습니까?	What kind of museum would you open if you were given the money for it?
하나의 질문에 대한 절대적인 진실을 알 수 있다면 무엇을 묻겠습니까?	If you could know the absolute truth about one question, what would you ask?
평균 하루 중 가장 안 좋은 부분은 무엇인가요?	What's the worst part of your average day?
나이가 들면서 기대되는 것은 무엇인가요?	What do you look forward to about getting old?
가장 의외의 사람들과 어울렸던 적은 언제였나요?	What was the most unlikely crowd of people you hung out with?
당신의 어린 시절을 어떻게 설명하시겠습니까?	How would you describe your childhood?
어떤 종류의 음악을 좋아하나요? 시간이 지남에 따라 취향이 어떻게 변했나요?	What kind of music do you like? How have your tastes changed over time?
현재보다 여행을 더 많이 하고 싶나요, 덜 하고 싶나요?	Would you like to travel more or less than you currently do?
친구에게 설득해서 하게 한 가장 어리석은 일은 무엇인가요?	What was a stupid thing you convinced a friend to do?
친구에게 가장 중요한 특성은 무엇인가요?	What's the most important trait for a friend to have?
아직도 즐기는 어린애 같은 것은 무엇인가요?	What childish thing do you still enjoy?
당신을 겁먹게 하거나 측정하기 어려운 사람은 누구인가요?	Who intimidates you or is hard to measure up to?
가장 기억에 남는 칭찬은 무엇인가요?	What was the best compliment you ever received?
사람들이 더 자주 서로에게 해야 할 말은 무엇인가요?	What should people say to each other more often?
가장 좋아하는 레스토랑에 대해 무엇을 사랑하나요?	What do you love about your favorite restaurant?
당신에게 가장 큰 영향을 미친 책, TV 프로그램, 영화, 음악은 무엇인가요?	What book, TV show, movie, or music has had the biggest impact on you?
버킷리스트에서 가장 중요한 것은 무엇인가요?	What's the #1 thing on your bucket list?
가장 좋아하는 대도시는 어디인가요?	What's your favorite big city?
첫눈에 반하는 사랑을 믿나요?	Do you believe in love at first sight?
중요한 새해 결심이나 목표를 달성한 적이 있나요?	When did you accomplish a New Years Resolution or goal that was important to you?
매주 추가로 $100의 용돈이 생긴다면 무엇을 하겠습니까?	What would you do with an extra $100 of spending money per week?
가장 아팠던 때는 언제였나요?	When were you the sickest you've ever been?
좋은 선생님이 될 것 같나요? 어떤 과목을 가르치겠습니까?	Do you think you would be a good teacher? Which subject would you teach?
TV 게임 쇼에 출연하고 싶습니까? 어떤 쇼에 출연하고 싶습니까?	Would you want to be on a TV game show? Which one?
다시는 하지 않을 일은 무엇인가요?	What's something you will NEVER do again?
곤란함으로 거의 죽을 뻔한 적이 있습니까?	Have you ever almost died from awkwardness?
갖고 싶은 초능력은 무엇인가요?	What superpower would you love to have?
어렸을 때 비밀 은신처가 있었나요?	Did you have a secret hiding place when you were a kid?
가장 좋아하는 소리는 무엇인가요? 미치게 하는 소리는 무엇인가요?	What is your favorite sound? What sound drives you insane?
꿈의 차가 있나요? 없다면 당신을 위해 설계된 차는 어떤 모습일까요?	Do you have a dream car? If not, what would a car specifically designed for you be like?
어떤 성격 특성은 적당하면 좋지만 과하면 안 좋은가요?	Which character trait is good until someone exhibits too much of it?
사람들을 기분 좋게 만드는 데 능숙한가요? 그렇다면 어떻게 합니까?	Are you good at cheering people up? If so, how do you do it?
어렸을 때 알았으면 좋았을 것은 무엇인가요?	What's one thing you wish you had known as a child?
자라난 동네에 대해 좋아했던 점은 무엇인가요?	What did you like about the neighborhood where you grew up?
세상에서 아이를 가지는 것의 가장 좋은 점은 무엇인가요?	What do you think in our world would be the best part of having kids?
언제 다른 사람들과 가장 연결된다고 느끼나요?	When do you feel most connected to others?
가장 좋아하는 역사적 인물은 누구인가요?	Who is your favorite historical figure?
다른 사람과 함께 배우면서 가장 재미있었던 것은 무엇인가요?	What thing did you have the most fun learning with someone else?
10살 때 되고 싶었던 것은 무엇인가요?	What did you want to be when you were 10 years old?
들어보고 싶은 대화는 무엇인가요?	What conversation would you like to have listened in on?
일어나자마자 가장 자주 하는 첫 번째 생각은 무엇인가요?	What's your most common first thought when you wake up?
어렸을 때 침대 아래에 괴물이 있다고 무서워했던 적이 있나요?	Were you scared there was a monster under your bed when you were little?
참여했던 가장 큰 소동은 무엇인가요?	What was the biggest fiasco you participated in?
다음 큰 구매는 무엇이 될 것 같나요?	What will your next big purchase be?
정기적으로 인용하는 영화는 무엇인가요?	What movie do you quote from regularly?
스타일을 마지막으로 바꾼 때는 언제였나요? 왜 바꿨나요?	When was the last time you changed your style? Why?
할머니에 대한 최고의 기억은 무엇인가요?	What's one of your best memories of one of your grandmothers?
가장 좋아하는 휴일 기억은 무엇인가요?	What's your favorite holiday memory?
언제 가장 살아있는 느낌이 드나요?	When do you feel most alive?
무언가에 엄청 늦었던 적이 있나요? 보통 시간을 잘 지키는 사람인가요?	When were you horribly late to something? Are you normally a punctual person?
당신의 삶에서 최고의 해 중 하나는 언제였나요?	What was one of the best years of your life?
기술에 대해 싫어하는 한 가지는 무엇인가요? 기술에 대해 좋아하는 한 가지는 무엇인가요?	What's one thing you hate about technology? What's one thing you love about technology?
누군가가 완전히 당신의 존경을 잃게 만드는 것은 무엇인가요?	How can someone completely lose your respect?
가장 좋아하는 아이스크림 토핑은 무엇인가요?	What is your favorite ice cream topping?
오랜 시간 동안 가장 스트레스를 받은 상황은 무엇인가요?	What has been one of the most stressful situations for you over the years?
작은 대화를 어떻게 접근합니까? 작은 대화를 잘한다고 생각하십니까?	How do you approach small talk? Would you say you're good at it?
초자연적 현상(유령, UFO 등)을 믿습니까? 유령이 나오는 장소에 대해 어떻게 생각합니까?	Do you believe in the supernatural (ghosts, UFOs, etc.)? How do you feel about haunted places?
가장 화나게 만드는 사람은 누구인가요?	Who pushes your buttons the most?
현재 가장 중요한 일에 어떻게 발을 들이게 되었나요?	How did you get started in your current, most important endeavor?
누군가가 당신을 위해 싸우거나 당신을 위해 일어섰던 적이 있나요?	When did someone stand up for you or fight for you?
당신의 성격 특성 중 가장 문제가 되는 것은 무엇인가요?	WHich of your personality traits gets you in the most trouble?
얼마나 자주 지루함을 느끼나요? 보통 어떻게 대처하나요?	How often do you feel bored? What do you usually do about it?
지난 5년 동안 갔던 좋은 휴가는 무엇인가요?	What was a great vacation you went on in the last 5 years?
대부분의 사람들이 해본 적 없는 일을 해본 적이 있나요?	What have you done that most people haven't?
우리만 사용할 수 있는 것을 발명할 수 있다면 무엇을 만들겠습니까?	If you could invent something that only we could use, what would it be?
얼마나 집에 있는 것을 좋아합니까? 얼마나 자주 외출하고 싶습니까?	"How much of a ""homebody"" are you? How often do you want to have a night out?"
다른 사람 때문에 창피했던 적은 언제인가요?	When were you embarrassed for someone else?
우연히 만난 일이 당신의 삶을 영원히 바꾼 적은 언제인가요?	What chance encounter changed your life forever?
오래 이야기할 수 있는 주제는 무엇인가요?	What topic could you spend hours talking about?
이상하게 먹는 음식은 무엇인가요? 맛있지만 먹기 힘든 음식은 무엇인가요?	What food do you eat in a weird way? What food is delicious but a pain to eat?
가장 평화로웠던 시기는 언제였나요?	When was the most peaceful time in your life?
가장 싫어하는 보드 게임이나 비디오 게임은 무엇인가요?	What board game or video game do you hate?
자신감이 더 있기를 바라나요? 그렇다면 왜 그렇습니까? 아니면 왜 그렇지 않습니까?	Do you wish you were more confident? Why or why not?
가장 좋아하는 패스트푸드 레스토랑은 어디인가요? 가장 싫어하는 곳은 어디인가요?	Which fast food restaurant is the best? Which one is the worst?
무언가가 자신에게 맞지 않다는 것을 언제 깨달았나요?	When did you realize something wasn't for you?
일출, 일몰, 또는 밤하늘 중 무엇을 보고 싶습니까?	Would you rather watch the sunrise, sunset, or night sky?
당신의 삶에서 가장 행복한 날은 언제였나요?	What was the happiest day of your life?
팀 플레이어인가요 아니면 혼자 일하는 편인가요?	Are you a team player or more of a lone wolf?
패션 감각이 있나요? 당신의 스타일을 어떻게 설명하시겠습니까?	How fashionable are you? How would you describe your style?
부모님에게 거짓말을 한 적이 있습니까? 만약 그렇다면 무엇에 대해 거짓말했나요? 들키지 않았나요?	Have you ever lied to your parents? If so, what about? Did you get away with it?
가장 최악의 시기는 무엇이었나요?	What was the worst phase you went through?
가장 무서운 동물은 무엇인가요?	Which animal scares you the most?
당신이 아는 가장 행복한 사람은 누구인가요? 어떻게 알 수 있나요?	Who is the happiest person you know? How can you tell?
항상 좋은 생각 같지만 드물게 좋은 생각인 것은 무엇인가요?	What always sounds like a good idea at the time but rarely is?
다른 사람들이 당신에 대해 어떻게 생각하는지 얼마나 신경 쓰나요?	How much do you care about what others think of you?
그만두었지만 후회하는 것은 무엇인가요?	What did you quit but wish you didn't?
마음에 특별한 자리를 차지하고 있는 TV 쇼는 무엇인가요? 왜요?	What TV show has a special place in your heart? Why?
대부분의 사람들이 즐기는 것을 강하게 싫어하는 것은 무엇인가요?	What do you strongly dislike even though most people enjoy it?
당신이 성숙해지는 데 도움을 준 사건은 무엇인가요?	What event helped you mature as a person?
지난 한 달 동안 가장 재미있었던 일은 무엇인가요?	What was one of the most fun things you did in the last month?
하나의 영화를 여러 번 보거나 하나의 책을 여러 번 읽는 것을 즐기나요?	Can you happily watch the same movie or read the same book multiple times in one year?
항상 끝내지 못하는 것은 무엇인가요? 자신을 미루는 사람이라고 생각합니까?	What's something you can never seem to finish? Do you think of yourself as a procrastinator?
가장 터무니없는 구매는 무엇이었나요?	What was the most ridiculous purchase you made?
눈에 보이지 않지만 사람들이 볼 수 있으면 좋겠다고 생각하는 것은 무엇인가요?	What's invisible but you wish people could see?
방문한 장소 중 냄새가 끔찍했던 곳은 어디인가요?	Where was a place you visited that smelled horrible?
당신의 장례식에서 사람들이 무엇을 말해주길 바라나요?	What do you hope people will say about you at your funeral?
사람들이 기본적으로 선하다고 생각합니까?	Do you think people are basically good?
오늘 당신에게 일어난 가장 좋은 일은 무엇인가요?	What was the best thing that happened to you today?
이상적인 사회적 외출은 무엇인가요?	What's your ideal social outing?
당신의 나라 밖의 세계에 대해 얼마나 알고 있습니까?	How much do you know about the world outside of your country?
다음 해에 한 번도 해본 적 없는 일을 하고 싶습니까?	What do you want to do in the next year that you've never done before?
잠을 자지 않아도 된다면 밤에 무엇을 하겠습니까?	If you didn't have to sleep, what would you do at night?
정말 즐기는 사치는 무엇인가요?	What is a luxury that you really enjoy?
당신을 독특하게 만드는 것은 무엇인가요?	What do you think makes you unique?
1년 동안 멘토로 삼고 싶은 사람은 누구인가요?	Who do you wish you could have as a mentor for one year?
당신이 가장 좋아하는 연장자 (부모님, 할아버지/할머니 등)는 누구인가요?\	Who is or was your favorite older person?
가장 좋아하는 예술 스타일이나 예술 작품은 무엇인가요?	What is your favorite art style or piece of art?
최근에 영감을 받은 것은 무엇인가요?	What has inspired you recently?
누군가를 자랑스럽게 여겼던 순간은 언제인가요?	When were you proud of someone?
사람들이 당신에 대해 가장 잘못 알고 있는 것은 무엇인가요?	What are people most likely to get wrong about you?
세상에 더 필요한 것은 무엇인가요?	What does the world need more of?
당신이 가진 나쁜 태도는 무엇인가요?	What do you have a bad attitude about?
5년 전과 비교했을 때 어떻게 달라졌나요?	How were you different 5 years ago?
더 자유롭고 재미있게 놀기를 바라나요?	Do you wish you were better at letting loose and having fun?
다른 사람들이 당신의 삶에서 배울 수 있는 교훈은 무엇인가요?	What lesson could others learn from your life?
지난 해에 일어난 가장 좋은 일은 무엇인가요? 가장 나쁜 일은 무엇인가요?	What was the best thing that happened to you in the last year? What was the worst thing?
얼마나 자주 당신의 뇌가 자동 조종 모드에 있습니까?	How often is your brain on autopilot?
당신의 휴대폰이나 컴퓨터에서 몇 시간 동안 할 수 있는 것은 무엇인가요?	What's something on your phone or computer that you can do for hours?
어렸을 때 일어난 재미있는 일은 무엇인가요?	What's something funny that happened when you were a kid?
어떤 가상의 캐릭터와 가장 친하게 지낼 수 있을 것 같나요?	Which fictional character do you think you could be really good friends with?
유튜브 채널, 팟캐스트, 블로그를 한다면 어떤 주제를 다루고 싶나요?	What topic would you cover if you had a YouTube channel, podcast, or blog?
가장 오랫동안 꾸준히 해온 취미는 무엇인가요?	What hobby have you been doing consistently for the longest time?
마법처럼 한 가지 세계 문제를 해결할 수 있다면 무엇을 선택하겠습니까?	If you could magically eradicate one world problem, which one would you pick?
부모님들이 아이들에게 가르치지 말아야 할 것은 무엇인가요?	What should parents stop teaching their kids?
상을 받은 적이 있나요? 그것에 대해 어떻게 느꼈나요?	Have you ever won an award? How did you feel about it?
쉽다고 생각했지만 시도해보니 어려웠던 것은 무엇인가요?	What was something you thought would be easy until you tried it?
어려운 사람들을 어떻게 대처하나요?	How do you deal with difficult people?
생각할 때마다 놀라운 것은 무엇인가요?	What blows your mind every time you think about it?
포기한 꿈은 무엇인가요?	What dream have you given up on?
사람이 인생을 크게 개선할 수 있는 작은 일은 무엇인가요?	What small thing can a person do to greatly improve his or her life?
가장 좋아하는 아침 시리얼은 무엇이며, 왜 좋아하나요?	What is your favorite breakfast cereal and why?
즉시 마스터하고 싶은 기술은 무엇인가요?	What skill do you wish you could instantly master?
다른 사람들이 거의 모르는 것은 무엇인가요?	What's something very few people know about you?
가장 호화로운 침대는 어디에서 잤나요?	Where was the fanciest bed you've slept in?
침실에서 가장 흥미로운 물건은 무엇인가요?	What's the most interesting object in your bedroom?
슬플 때 무엇이 위로가 되나요?	What comforts you when you're sad?
아빠에 대한 최고의 기억 중 하나는 무엇인가요?	What's one of your best memories of your dad?
어디에서 은퇴하고 싶으며 은퇴 후 무엇을 하고 싶나요?	Where would you like to retire, and what would you do in retirement?
방 안에서 가장 웃기거나 가장 똑똑한 사람이 되고 싶나요?	Would you rather be the funniest or smartest person in the room?
가장 좋아하는 선생님은 누구였나요? 그들을 특별하게 만든 것은 무엇인가요?	Who was your favorite teacher? What made them special?
도시에서 살고 싶나요, 아니면 시골에서 살고 싶나요?	Would you rather live in the city or the countryside?
가장 극심한 통증은 무엇이었나요?	What is the most excruciating pain you've ever experienced?
가장 쇼핑하기 좋아하는 것과 싫어하는 것은 무엇인가요?	What's your favorite thing to shop for? Least favorite?
가장 나쁜 팀과 가장 좋은 팀은 무엇이었나요?	What was the worst team you've been on? What was the best?
가장 기억에 남는 생일은 무엇인가요?	What was your most memorable birthday?
특별했던 장소가 문을 닫았거나 더 이상 존재하지 않는 경우가 있나요?	Is there a place that was special to you that has gone out of business or no longer exists?
동물과 대화할 수 있다면 어떤 동물과 가장 대화하고 싶나요?	If you could talk to animals, which animal would you most want to talk to?
당신을 더 나은 사람으로 밀어붙이는 사람은 누구인가요?	Who pushes you to be a better person?
주먹다짐을 한 적이 있나요? 그 이유와 결과는 무엇인가요?	Have you ever been in a fistfight? Over what and what happened?
한 달 동안 무료로 휴가를 보낼 수 있다면 어디에서 보내고 싶나요?	Where would you love to vacation for one month if it was entirely free?
사람들이 얼마나 변할 수 있다고 생각하나요?	To what extent do you think people can change?
가장 나쁜 직업은 무엇이었나요?	What was the worst job you ever had?
가장 외진 곳은 어디였나요?	Where is the most secluded place you've ever been?
가장 흥미로운 역사적 시대는 무엇인가요?	What historical period do you find most interesting?
경쟁적인 성격인가요? 이를 긍정적으로 보나요, 부정적으로 보나요?	How competitive are you? Do you see that as a positive or a negative?
세상을 한 문장으로 어떻게 보나요?	How would you describe how you see the world in one sentence?
정확히 1년 후에 죽는다면 어떻게 다르게 살 것인가요?	How would you live differently if you knew you'd die in exactly one year?
가장 이상한 음식은 무엇이었나요?	What was the weirdest food you ever ate?
가장 오랫동안 깨어 있었던 시간은 얼마나 되나요?	What's the longest you've stayed awake?
현재 직업이나 프로젝트에서 가장 두려운 것은 무엇인가요?	What scares you most about your current job or project?
잃어버린 물건 중 되찾고 싶은 것은 무엇인가요?	What's a lost object that you'd love to have back?
좋은 느낌을 받기 위해 밤에 몇 시간의 수면이 필요합니까? 낮잠을 좋아합니까?	How many hours of sleep per night do you need to feel good? Do you like naps?
어떤 사람이 당신의 마음을 감동시켰나요?	How has someone touched your heart?
처음 만나는 사람이 아마도 당신에 대해 좋아할 것은 무엇인가요?	What is someone meeting you for the first time probably going to like about you?
최고의 이야기꾼은 누구인가요? 그들의 이야기가 좋은 이유는 무엇인가요?	Who is the best storyteller you know? What makes their stories so good?
잃어버린 우정을 아직도 그리워하나요?	Have you lost a friendship that you wish was still strong?
풍요로운 삶을 위한 비결은 무엇인가요?	What's the recipe for a rich life?
두 위치 사이를 마음껏 텔레포트할 수 있다면 어떤 위치를 선택할까요?	If you could teleport between exactly two locations as often as you wanted, which two would you choose?
더 나은 친구가 되기 위해 어떻게 할 수 있을까요?	How do you think you could be a better friend?
놀랍도록 빨리 친구가 된 사람은 누구인가요?	Who did you become friends with surprisingly quickly?
연애나 관계에서 배운 것은 무엇인가요?	What have you learned from dating or being in a relationship?
모든 공립학교 학생이 반드시 들어야 할 유용한 수업은 무엇인가요?	What useful class should all public school students have to take?
생각보다 더 자주 일어나는 일은 무엇인가요?	What happens more often than you'd like?
가장 좋은 조언이나 가장 나쁜 조언은 무엇이었나요?	What was the best or worst advice you ever received?
사람들을 판단하는 데 너무 빠르거나 너무 느리진 않나요?	Are you usually too quick or too slow to judge people?
매일 행복하게 먹을 수 있는 음식이 있나요?	Is there a food you could happily eat every day of your life?
매력적인 문화는 무엇인가요?	Which culture do you find fascinating?
다른 세대의 사람들은 서로 어떻게 비슷하고 다릅니까?	How are people of different generations similar to, or different from each other?
다른 사람들과의 신체 접촉은 얼마나 되나요? 포옹, 악수, 등을 두드리기 등.	How much physical contact do you have with others? Hugs, handshakes, pats on the back, etc?
이상한 방식으로 돈을 번 적이 있나요?	What's an unusual way that you've made money?
새로운 것이나 불편한 것을 얼마나 자주 시도합니까? 최근의 예는 무엇인가요?	How often do you try new or uncomfortable things? What's a recent example?
직감이나 '느낌을 따르는 것'에 대해 어떻게 생각하나요?	"What do you think about intuition, or ""following your gut""?"
몇 시간 동안 이야기할 수 있는 것은 무엇인가요?	What could you talk about for hours?
가장 모험적인 일들은 무엇인가요?	What are the most adventurous things you've done?
지난 5년 동안 당신의 삶은 어떻게 변했나요?	How has your life changed in the past five years?
전통적인 성 역할, 직업, 기사도 등에 대해 어떻게 생각합니까?	What are your thoughts on traditional gender roles, occupations, chivalry, etc?
일반적인 하루의 첫 시간을 설명하세요.	Describe the first hour of your typical day.
오늘 1천만 달러를 받거나 건강한 5년을 추가로 받는다면 무엇을 선택할까요?	You can have $10 million today, or 5 healthy years added to your life. Which will you choose?
미래 세대가 현재 우리 시대에 대해 놀라거나 우스꽝스럽다고 생각할 것은 무엇인가요?	What will future generations find amazing or ridiculous about our current times?
완수하기에 기분이 좋았던 큰 작업이나 프로젝트는 무엇인가요?	What big task or project did it feel fantastic to complete?
무서운 상황이나 위험한 상황에 처한 적이 있나요?	When have you been in a scary or dangerous situation?
항상 당신 곁에 있어준 사람은 누구인가요?	Who has always been there for you?
비이성적인 두려움이 있나요? 만약 있다면 왜 그런지 아십니까?	Do you have any irrational fears? If so, do you know why?
점성술, 마술, 영매 등 오컬트에 대해 어떻게 생각하나요?	What do you think of the occult; astrology, magic, psychics, etc?
당신은 내향적인가요, 외향적인가요? 몇 가지 예를 들어주세요.	Are you more of an introvert, or an extrovert? What are some examples?
성장하면서 종교가 당신에게 어떤 영향을 미쳤나요?	How did religion influence you while growing up?
대화에서 직설적인가요, 아니면 신중한가요?	In conversation, are you blunt, or tactful?
자랑스러웠던 소유물이나 성취는 무엇인가요?	What have you been proud to own or accomplish?
포기에 대해 어떻게 생각합니까? 포기한 적이 있거나 포기하고 싶었던 적이 있습니까?	How do you feel about quitting? When have you quit, or wanted to?
당신의 약점, 아킬레스건은 무엇인가요?	What's your weakness, your Achilles heel?
부유한 사람들이 덜 가진 사람들을 도와야 할 의무가 있습니까?	Are the rich obligated to help those with less?
명상을 하거나 마음을 진정시키는 다른 방법이 있습니까?	Do you meditate, or have another way to quiet your mind?
유전자 변형이 안전하고 저렴하다면 자신에 대해 무엇을 바꾸고 싶습니까?	If genetic alteration was safe and affordable, would you change anything about yourself?
어려운 방법으로 배운 교훈은 무엇입니까?	What lesson did you learn the hard way?
좋아하는 로드 트립 기억이 있습니까?	Do you have any favorite road trip memories?
무엇에 대해 책임이 있으며 무엇이 통제 밖에 있습니까?	What are you responsible for, and what is outside your control?
어렸을 때는 했지만 지금은 절대 하지 않을 일은 무엇입니까?	What did you do when you were younger, that you would never do now?
학교에 대해 가장 좋아했던 것은 무엇입니까? 그에 대해 무엇을 기억합니까?	What was your favorite thing about school? What do you remember about it?
집과 학교 외에 어린 시절 많은 시간을 보낸 곳은 어디입니까?	Other than at home and school, where did you spend lots of time while growing up?
운전 배우기에 대해 기억하는 것은 무엇입니까?	What do you remember about learning to drive?
미니멀리스트인가요, 아니면 많은 물건을 가지는 것을 좋아합니까?	Are you a minimalist, or do you enjoy having lots of stuff?
어렸을 때 가장 소중했던 소유물은 무엇입니까?	What were some of your most prized possessions as a child?
피를 나눈 가족은 아니지만 가족이라고 여기는 사람이 있습니까?	Is there anyone you consider family, even though you're not blood relatives?
당신의 시간은 얼마나 가치가 있습니까?	How valuable is your time?
무엇인가에 대해 너무 흥분하거나 불안해서 잠을 잘 수 없었던 적이 있습니까?	When have you been so excited or anxious for something that you couldn't sleep?
종교는 어떤 목적을 수행합니까? 우리는 항상 종교를 가질까요?	What purpose does religion serve? Will we always have religion?
어떤 유형의 운전자입니까? 느긋한, 불안한, 짜증나는, 신중한 등.	What kind of driver are you? Relaxed, anxious, irritable, cautious, etc?
아는 것이 아니라 아는 사람이다라는 말이 얼마나 진실합니까?	"How true is the saying ""It's not what you know, but who you know""?"
오래된 친구들과 얼마나 잘 연락을 유지하고 있습니까?	How well have you kept in touch with old friends?
쉽게 할 수 있는 것은 무엇인가요?	What comes easily to you?
"걱정은 ""상상력의 오용""이라는 말이 있습니다. 걱정에 대해 어떻게 생각합니까?"	"It's been said that worry is ""a misuse of the imagination"". What do you think about worry?"
가장 가까운 친구와 어떻게 만났나요?	How did you meet your closest friend(s)?
누군가 당신에게 놀랍도록 관대했던 때를 공유하세요.	Share a time when someone was surprisingly generous to you.
어떤 종류의 경쟁을 즐깁니까?	What sort of competition do you enjoy?
다양성이 중요합니까, 아니면 습관의 동물입니까? 예를 들어보세요.	Is variety important to you, or are you a creature of habit? What's an example?
당신의 인생에서 기쁘게 여기는 큰 변화는 무엇입니까?	What big change are you happy that you made in your life?
물건을 고치는 데 능숙합니까? 그것을 즐깁니까?	Are you good at fixing things? Do you enjoy it?
손에 쥐어본 돈 중 가장 많은 금액은 얼마입니까?	What's the most money you've held in your hand?
혼자 살아본 적이 있습니까? 그것을 즐겼습니까?	Have you ever lived alone? Did you enjoy it?
유령이나 다른 초자연적 현상을 믿습니까? 왜 그런가요?	Do you believe in ghosts or other supernatural phenomena? Why?
당신의 인생에서 가장 재미있고 흥미진진한 시기는 언제였나요?	What was the most fun or exciting time in your life?
성공은 무엇을 의미합니까?	What does success mean to you?
지진, 허리케인 또는 다른 극심한 자연 현상을 경험한 적이 있습니까?	Have you experienced an earthquake, hurricane, or other extreme natural event?
물이나 다른 동물들이 당신의 삶에 얼마나 중요했습니까?	How important have pets or other animals been in your life?
누군가를 심하게 오해한 적이 있습니까?	Have you ever badly misjudged someone?
심령 비전, ESP 등을 믿습니까? 그런 경험이 있습니까?	Do you believe in psychic visions, ESP, etc? Have you had any experiences?
당신이 어색하거나 부적절한 말을 했던 때를 기억하세요.	Remember a time when you have said or done something awkward or inappropriate.
다음 문장을 완성하세요: 나는 절대 _____ 사람과 데이트할 수 없습니다.	Finish the following sentence: I could never date someone who _______.
행운의 기회나 동시성의 사례가 있었습니까?	Have you ever had a lucky break, or a case of synchronicity?
쇼에서 관객 자원 봉사자로 뽑힌 적이 있습니까?	Have you ever been chosen as an audience volunteer for a show?
어렸을 때 무엇을 꿈꿨나요?	As a child, what did you daydream about?
자비란 무엇입니까? 누가 자비로운가요?	What is compassion? Who is compassionate?
가장 좋은 재정적 결정은 무엇이었습니까?	What's the best financial decision you've made?
무엇이 당신에게 희망을 줍니까?	What gives you hope?
공개적으로 공유하는 것과 비공개로 유지하는 것이 무엇인가요?	What do you share openly, and what is best kept private?
처음으로 바람을 맞은 것을 기억하나요?	Do you remember the first time you had the wind knocked out of you?
어색하지만 필요한 대화를 잘하나요? 아니면 피하나요?	Are you good at having awkward but necessary conversations? Or do you avoid them?
실수와 실패에 대해 어떻게 생각합니까?	How do you feel about mistakes and failure?
가장 좋아하는 장소는 어디인가요? 무엇이 그것을 특별하게 만드나요?	What is one of your favorite places? What makes it special?
새 학교, 직장, 도시 등에서 첫날에 강렬한 기억이 있습니까?	Do you have any strong memories from your first day in a new school, job, city, etc?
의식을 잃은 적이 있습니까? 무슨 일이 있었나요?	Have you ever been knocked unconscious? What happened?
도덕적으로 받아들일 수 있지만 불법인 것은 무엇입니까?	What is something illegal, that you find morally acceptable?
누구를 존경합니까? 왜 존경합니까?	Who do you admire? Why?
지도자형인가요, 추종자형인가요?	Are you more of a leader or a follower?
다른 사람들이 성공하는 것을 볼 때 어떻게 느낍니까?	How do you feel when you see others succeed?
나중에 후회하는 말을 한 적이 있습니까?	Do you say things you later regret?
잘못된 시간이나 장소에서 급하게 화장실이 필요했던 적이 있습니까?	Have you ever urgently needed a toilet at the wrong time or place?
어렸을 때 자란 동네에 대해 무엇을 기억합니까?	What do you remember about the neighborhood you grew up in?
다른 사람들이 당신에 대해 어떻게 생각하는지 얼마나 신경 씁니까? 그것이 당신의 삶에 어떤 영향을 미칩니까?	How much do you care what others think of you? How does it affect your life?
어린 시절 성인이 친절하게 대해준 때를 기억하세요.	Remember a time during your childhood when an adult did something kind for you.
가장 나쁜 재정적 결정은 무엇이었습니까?	What's the worst financial decision you've made?
거짓말이 불가능하다면 세상은 어떻게 변할까요?	How would the world change if lying wasn't possible?
세상에서 어떤 직업이라도 가질 수 있다면 무엇을 선택할까요?	Imagine you can have any job in the world. What will you choose?
어렸을 때 부모님은 어떤 일을 하셨나요? 그것에 대해 무엇을 기억합니까?	What work did your parents do when you were young? What do you remember about it?
경쟁에 대해 어떻게 생각합니까?	How do you feel about competition?
당신의 최고의 성격은 무엇입니까? 최악의 성격은 무엇입니까?	What are some of your best traits? Some of your worst?
두려움 때문에 뒷걸음질 친 적이 있습니까? 실패, 거절, 미지의 것에 대한 두려움 등.	When have you let fear hold you back? Fear of failure, rejection, the unknown...
부모님에게 거짓말을 한 적이 있습니까? 만약 있다면 어떻게 했나요?	Do you remember lying to your parents? If so, how?
자신의 죽음을 생각합니까?	Do you think about your own mortality?
어떤 종류의 코미디를 좋아합니까? 예시가 있나요?	What sort of comedy do you like? Any examples?
당신이 공유할 수 있는 당황스러운 순간을 기억하세요.	Can you remember an embarrassing moment you're willing to share?
좋은 팀의 일원이었을 때를 기억하세요. 무엇이 기억에 남나요?	When have you been part of a good team? What do you remember about it?
"얼마나 많은 돈이 사람을 ""부유""하게 만드나요?"	"What amount of money makes someone ""rich""?"
다른 사람들이 모르는 과거의 성취를 공유하세요.	Share a past accomplishment of yours that others don't know about.
불운, 징크스, 저주 등을 믿습니까?	Do you believe in bad luck, jinxes, curses, etc.?
선택한 선생님과 함께 공부하고 싶은 재미있거나 흥미로운 주제는 무엇인가요?	What would be a fun or interesting subject to study with a teacher of your choice?
거짓말을 해도 되는 경우가 있나요?	Is it ever ok to lie?
과소평가받은 적이 있나요?	When have you been underestimated?
당신에게 중요했던 건물이 나 장소가 이제는 존재하지 않습니까?	What building or place was important to you, that doesn't exist now?
가장 큰 결정 중 하나는 무엇입니까? 그것을 하지 않았다면 어떻게 되었을까요?	What is one of the biggest decisions you've made? What if you hadn't made it?
가십에 대해 어떻게 생각합니까? 얼마나 자주 가십합니까?	What do you think about gossip? How often do you gossip?
어떤 활동 중 시간이 눈 깜짝할 사이에 지나가는 것을 느낍니까?	During what activity does time seem to pass without you noticing?
어떤 이유로 어떤 장소는 부유하거나 가난합니까?	Why are some places richer or poorer than others?
무대에 마지막으로 오른 때를 기억합니까? 무대에 자주 오르나요?	Do you remember the last time you were on a stage? Have you been on stage often?
어떤 종류의 재회를 참석한 적이 있습니까? 만약 그렇다면 어땠나요?	Have you attended any sort of reunion? If so, how was it?
도시에서 시간을 보내고 싶습니까, 자연에서 시간을 보내고 싶습니까? 왜 그런가요?	Would you rather spend time in the city, or in nature? Why?
부모가 되는 것이 한 사람의 삶에 어떻게 영향을 미칩니까? 긍정적이든 부정적이든.	How does parenthood affect one's life, positive and negative?
동네나 학교에서 다른 아이들과 어떻게 달랐나요?	How were you different from the other children in your neighborhood or school?
얼마나 자주 칭찬을 합니까? 그것이 당신을 어떻게 느끼게 합니까?	How often do you give compliments? How does it make you feel?
꿈을 얼마나 자주 기억합니까? 어떤 종류의 꿈을 꾸나요?	How often do you remember your dreams? What sort of dreams do you have?
가족이 어떤 모습이어야 하는지에 대한 훌륭한 예는 누구입니까? 왜 그렇습니까?	Who are great examples of what a family should be? Why?
사람들이 때때로 당신을 잘못 판단하는 방식은 무엇입니까?	In what way do people sometimes misjudge you?
선물 주고 받는 것에 대해 어떻게 생각합니까? 특별한 기억이 있나요?	How do you feel about giving and receiving gifts? Any favorite memories?
성형 수술을 고려하시겠습니까? 만약 저렴하고 100% 안전하다면요?	Would you consider cosmetic surgery? What if it was affordable and 100% safe?
인생의 몇 퍼센트가 결정과 행동에 의존하고, 몇 퍼센트가 운에 의존합니까?	How much of life depends on decisions and actions, versus luck?
참여하지 않는 사회적 규범은 무엇입니까?	What societal norms do you not take part in?
보통 새것을 삽니까, 아니면 중고를 삽니까? 왜 그런가요?	Do you normally buy new or used? Why?
대학 학위가 얼마나 중요합니까? 시간이 지남에 따라 이것이 변했나요?	How important is a college degree? Has this changed over time?
누군가가 다칠 때 재미있을 수 있습니까? 왜 그런가요?	Can it be funny when someone gets hurt? Why?
어떤 종류의 예술을 좋아합니까? 왜 그런가요?	What sort of art do you like? Why?
당신은 비밀스러운 사람인가요, 아니면 열려 있는 사람인가요?	Are you a private person, or an open book?
중요한 문제에 대해 생각이 바뀐 적이 있습니까? 만약 있다면 왜 그런가요?	Have you changed your mind on an important issue? If so, why?
기억력이 어떻습니까? 어떤 종류의 것들을 기억하거나 잊습니까?	How is your memory? What sorts of things do you remember or forget?
얼마나 자주 휴대폰과 다른 기기에서 떨어져 있습니까?	How often are you away from your phone and other devices?
당신은 얼마나 판단적인가요?	How judgmental are you?
받았던 최고의 선물 중 하나는 무엇입니까?	What is one of the best gifts you've ever received?
무엇을 배우는 것을 즐기나요? 어떻게 배우나요?	What do you enjoy learning about? How do you learn it?
다른 지역으로 이사한다면 현재 집에서 무엇을 그리워할까요?	If you moved to another area, what would you miss about your current home?
영웅이 되어 누군가를 부상이나 죽음에서 구한 적이 있습니까? 누군가가 당신을 구한 적이 있습니까?	Have you ever been a hero, saving someone from injury or death? Has anyone saved you?
세상은 사랑스럽습니까, 적대적입니까, 무관심합니까?	Is the world loving, hostile, or indifferent?
무언가를 하기 전에 긴장했던 때를 기억하세요. 그것은 어떻게 되었습니까?	Remember a time you felt nervous before doing something. How did it go?
많은 사람들이 동의하지 않는 중요한 진실은 무엇입니까?	What important truth do few people agree with you on?
당신의 삶의 전환점은 무엇이었습니까?	What was a turning point in your life?
아이들에게 거짓말을 해도 되는 경우가 있나요? 만약 있다면 언제인가요?	Is it ever ok to lie to children? If so, when?
어떻게 가장 잘 배우나요? 보기, 듣기, 하기, 읽기?	How do you best learn? Watching, hearing, doing, reading?
다른 사람들이 재미있다고 생각하는 실수를 했을 때 스스로 웃을 수 있습니까?	When you make a mistake that others find funny, are you able to laugh at yourself?
현재 가장 중요한 목표는 무엇입니까?	What is your most important goal right now?
친구와 가족에게 어떻게 인사하고 작별 인사를 하나요? 악수, 포옹, 키스 등.	How do you greet and say goodbye to your friends & family? A handshake, hug, kiss, etc?
당신은 갑자기 억만장자가 되었습니다. 자신에게 무엇을 사시겠습니까? 다른 사람들에게는요?	You just became a billionaire. What will you buy for yourself? And for others?
사람들이 다른 사람에게 해를 끼치지 않는 한 무엇이든 자유롭게 할 수 있어야 합니까?	Should people be free to do anything they want, if they're not hurting anyone else?
당신의 외모, 피부색, 국적 등이 다른 사람들이 당신을 대하는 방식에 영향을 미친 적이 있습니까?	When has your physical appearance, skin color, nationality, etc. affected how others treated you?
피하고 싶은 사회적 관습은 무엇입니까?	What social custom would you rather avoid?
학교에서 가장 즐겼던 수업은 무엇입니까?	What class did you most enjoy in school?
첫 번째 차량에 대해 무엇을 기억합니까?	What do you remember about your first vehicle?
뼈를 부러뜨린 적이 있습니까? 무슨 일이 있었나요?	Have you ever broken a bone? What happened?
남성과 여성이 세상에서 갖는 서로 다른 장점은 무엇입니까?	What different advantages do men and women have in the world?
특히 어색했던 가족 순간을 기억합니까?	Can you recall an especially awkward family moment?
온라인 쇼핑 이전의 시대를 기억합니까? 그때의 삶은 어땠나요?	Do you remember the time before online shopping? How was life different then?
친구가 많습니까, 아니면 몇 명의 가까운 친구가 있습니까?	Do you have many friends, or a few close friends?
형제자매가 있습니까? 그들이 당신에게 어떤 영향을 미쳤습니까?	Do you have siblings? How have they influenced you?
조언을 구하는 사람은 누구입니까?	Who do you go to for advice?
특별한 생일이 있었습니까? 왜 그랬나요?	Was a particular birthday meaningful for you? Why?
좋은 청취자가 되는 것은 무엇입니까? 당신은 좋은 청취자인가요?	What makes a good listener? Are you a good listener?
작은 순간이 큰 변화를 가져온 때는 무엇입니까?	What small moment in your life led to a big change?
여행을 많이 했습니까? 하고 싶습니까? 왜 그런가요?	Have you done much traveling? Would you like to? Why?
모든 돈이 충분히 있다고 상상해보세요. 시간을 어떻게 보낼 것인가요?	Imagine you have all the money you will ever need. How will you spend your time?
시간 엄수는 얼마나 중요한가요? 당신은 보통 시간을 잘 지키나요?	How important is punctuality? Are you usually on time?
얼마나 자주 요리를 하나요? 요리를 즐기나요?	How often do you cook? Do you enjoy it?
당신이 알고 있는 가장 친절한 사람들은 누구인가요?	Who are some of the kindest people you've known?
당신의 가장 큰 업적 중 하나는 무엇입니까? 왜 그것을 했나요?	What is one of your greatest achievements? Why did you do it?
부적절한 상황에서 웃음을 멈출 수 없었던 적이 있나요?	Have you been unable to stop laughing at an inappropriate time?
언젠가 인간이 지구 밖에서 살게 될까요?	Will humans someday live off Earth?
언제 두려움을 극복했습니까? 어떻게 했습니까? 그때 어떤 느낌이었나요?	When have you overcome your fear? How did you do it? How did it feel?
프라이버시의 미래는 어떻게 될까요? 100년 후에도 사람들은 프라이버시를 중요하게 여길까요?	What is the future of privacy? Will people value privacy 100 years from now?
어려운 감정(분노, 두려움, 슬픔 등)을 어떻게 처리합니까?	How do you deal with difficult emotions? Anger, fear, sadness, etc.
당신의 최고의 모습을 이끌어내는 사람은 누구입니까? 어떻게 그렇게 하나요?	Who brings out the best in you? How?
어렸을 때 당신의 영웅은 누구였습니까? 왜 그랬나요?	Who was a hero of yours while growing up? Why?
절대 잡히지 않을 것이라는 것을 알았다면 어떤 법을 어기겠습니까?	If you knew you would never be caught, which laws would you break?
현대 의료 혜택을 받아서 특히 감사했던 적이 있습니까?	When have you been particularly grateful to have access to modern healthcare?
재미를 위해 무엇을 하나요? 무엇이 그것을 좋아하게 만드나요?	What do you do for fun? What do you like about it?
어렸을 때 즐겼던 야외 활동은 무엇입니까?	What outdoor activity did you enjoy as a child?
길을 잃었던 적이 있나요? 무슨 일이 있었나요?	When have you gotten lost? What happened?
당신에 대한 믿음이 당신 스스로에 대한 믿음을 증가시킨 사람은 누구인가요?	Who's belief in you increased your belief in yourself?
용기는 무엇을 의미하나요? 누가 용감한가요?	What does courage mean to you? Who is courageous?
인간이 기술과 융합될 것이라고 생각합니까? 만약 그렇다면 세상은 어떻게 변할까요?	Do you think humans will merge with technology? If so, how will it change the world?
태도는 한 사람의 삶에 어떤 영향을 미칩니까?	How does attitude affect one's life?
일관된 취침 시간을 갖고 있습니까? 그것이 당신에게 중요한가요?	Do you have a consistent bedtime? Is it important to you?
기르고 싶은 습관이나 버리고 싶은 습관이 있나요?	Is there a habit you would like to develop? Or one you would like to break?
정신력은 얼마나 중요한가요? 당신은 정신력이 강한가요?	How important is mental toughness? Are you mentally tough?
첫 데이트는 어땠나요? 그것에 대해 무엇을 기억합니까?	How was your first date? What do you remember about it?
현실적이어야 하나요, 아니면 꿈을 따라가야 하나요? 둘 다 할 수 있나요?	Should we be realistic, or follow our dreams? Can we do both?
오래 살기를 기대합니까? 왜 그렇거나 왜 그렇지 않나요?	Do you expect to live a long life? Why, or why not?
거절을 얼마나 자주 경험했습니까? 어떻게 대처하나요?	How often have you experienced rejection? How do you handle it?
다른 사람들이 모르는 직업을 가진 적이 있습니까?	What job have you had that others might not know about?
과거나 미래의 어느 시간과 장소를 방문할 수 있다면 어디로 갈 것인가요?	You can visit any time and place in the past or future. Where will you go?
선생님, 코치, 상사 등과 잘 지내셨나요?	Have you gotten along well with your teachers, coaches, bosses, etc?
두 개 이상의 언어를 구사합니까? 그렇지 않다면 배우고 싶은 언어가 있나요?	Do you speak more than one language? If not, would you like to?
현재의 직업이나 과거의 직업에 어떻게 이르게 되었나요?	How did you end up in your present or past occupation?
부모님과 어떻게 비슷하고 어떻게 다른가요?	In what ways are you similar to your parents? And how are you different?
대부분의 사람들은 신뢰할 만하고 믿을 만한가요? 당신은 사람을 빠르게 신뢰하나요?	Are most people trustworthy and reliable? Are you quick to trust people?
합법적이지만 사회적으로 용납되지 않는 것은 무엇인가요?	What is legal, but socially unacceptable?
자신을 다른 사람과 자주 비교합니까? 그것이 도움이 되나요, 해롭나요?	Do you often compare yourself to others? Is it helpful or harmful?
$20로 할 수 있는 가장 재미있는 일은 무엇입니까?	What's the most fun you can have for $20?
정식 무도회에 참석한 적이 있습니까? 그때 무엇이 기억에 남나요?	Have you been to a formal dance? What do you remember about it?
당신의 가족에 대해 특별하거나 흥미로운 것은 무엇인가요?	What is different or interesting about your family?
어떤 사람들과 어울리는지가 얼마나 중요한가요? 얼마나 신중하게 선택합니까?	How important is the company you keep? How selective are you?
온라인 데이팅이 사회에 긍정적인 변화를 가져왔습니까?	Has online dating been a positive change for society?
당신의 인내심을 시험하는 것은 무엇인가요? 어떻게 대처합니까?	What tests your patience, and how do you deal with it?
자신을 위해 실용적이지 않은 것에 백만 달러를 써야 합니다. 무엇을 사겠습니까?	You must spend a million dollars on impractical things for yourself. What will you buy?
첫 번째 콘서트는 무엇이었나요?	What was the first concert you went to?
기분이 음악 선택에 어떻게 영향을 미칩니까?	How does your mood affect the music you choose?
어떤 실패가 당신을 더 강하게 또는 현명하게 만들었습니까?	What failure made you stronger or wiser?
현재의 수입을 위해 일하는 시간을 절반으로 줄이거나, 현재의 시간 동안 일하고 수입을 두 배로 늘리기를 원합니까?	Would you rather work half as much for your current income, or work your usual hours and double your income?
큰 결정을 어떻게 내립니까? 신중하게 분석합니까? 직감에 따라 갑니까?	"How do you make big decisions? Do you patiently analyze? Do you ""go with your gut""?"
좋아하는 책이나 장르가 있습니까? 무엇을 좋아하나요?	Do you have a favorite book or genre? What do you like about it?
얼마나 미신적인가요?	How superstitious are you?
어떤 억양을 좋아합니까? 자신에게 새로운 억양을 선택할 수 있다면 무엇을 선택하겠습니까?	What accents do you like? If you could choose a new accent for yourself, what would you choose?
비 오는 날을 즐깁니까? 왜 그렇습니까?	Do you enjoy a rainy day? Why?
자주 사용할 것이라고 예상했지만 사용하지 않는 것은 무엇인가요?	What is something you expected to use often, but you don't?
자신의 조상에 대해 무엇을 알고 있습니까? 그것이 당신에게 중요한가요?	What do you know about your ancestry? Is it important to you?
지구 밖에 생명이 존재한다고 믿습니까? 지적 생명체가 존재한다고 믿습니까?	Do you believe life exists outside Earth? Intelligent life?
후회가 있습니까? 후회가 유용하다고 생각합니까?	Do you have any regrets? Is it useful to have regrets?
밤 외출을 선호합니까, 아니면 집에서의 밤을 선호합니까? 시간이 지나면서 이것이 변했나요?	Do you prefer a night out, or a night in? Has this changed over time?
유명인이 소유했던 아이템을 하나 가질 수 있다면 무엇을 선택하겠습니까?	You can have any item once owned by someone famous. What do you choose?
가장 무서운 일을 한 적이 있습니까?	What's the scariest thing you've done?
외딴 섬에서 다른 사람과 1년을 보내야 합니다. 누구를 선택하겠습니까?	You must spend a year on a remote island with only one other person. Who will you choose?
삶에서 원하는 것이 무엇인지 알고 있습니까?	Do you know what you want in life?
어떤 운동을 즐기나요? 무엇이 그것을 좋아하게 만드나요?	What kind of exercise do you enjoy? What do you like about it?
오랫동안 연락이 끊긴 사람과 다시 연락을 주고받은 적이 있습니까?	Have you gotten back in touch with someone after a long time apart?
어린 시절 혼자 시간을 많이 보냈나요? 혼자 무엇을 즐겼나요?	Did you spend much time alone as a child? What did you enjoy doing by yourself?
자신이 되기 위해 용기가 필요했던 때가 있습니까?	When has it taken courage to be yourself?
하늘에서 설명할 수 없는 물체를 본 적이 있습니까?	Have you ever seen an unexplained object in the sky?
방문하고 싶은 나라는 어디입니까? 왜 그렇습니까?	What country would you like to visit? Why?
승리와 패배에 어떻게 대처합니까? 승리할 때 겸손합니까, 패배할 때 관대합니까?	How do you deal with winning and losing? Are you humble in victory, gracious in defeat?
당신은 잘 정리된 사람인가요? 어떻게 그렇게 합니까?	Are you well-organized? How do you do it?
종교, 과학, 또는 둘 다에 신뢰를 두고 있습니까?	Do you put your faith in religion, science, or both?
가장 어리석은 방법으로 다친 적이 있습니까?	What's one of the stupidest ways you've gotten hurt?
어렸을 때 가장 좋아했던 활동은 무엇입니까? 그것이 당신에게 어떤 영향을 미쳤습니까?	What was a favorite activity when you were young? How did it influence you?
첫 술자리 경험에 대해 무엇을 기억합니까?	What do you remember about your first time drinking alcohol?
무언가에 도전한 적이 있습니까? 결과는 어땠습니까?	When have you tried out for something? How did it go?
당신의 성격 특성 중 어떤 것이 인생에서 가장 도움이 되었습니까?	Which of your personality traits have helped you most in life?
법을 어기는 것이 도덕적으로 받아들일 수 있는 경우는 언제입니까?	When is it morally acceptable to break the law?
초기나 중요한 죽음 경험이 있었나요? 어떻게 대처했습니까?	Did you have an early or significant experience with death? How did you deal with it?
부모님이나 다른 롤 모델이 돈에 대해 가르쳐 준 것은 무엇입니까?	What did your parents or other role models teach you about money?
휴식 시간이 얼마나 중요한가요? 충분히 휴식하고 있습니까?	How important is time to relax? Do you get enough?
악기를 연주합니까? 그렇지 않다면 배우고 싶은 악기가 있습니까?	Do you play a musical instrument? If not, would you like to?
그룹 의사 결정을 할 때, 의견을 적극적으로 말합니까 아니면 다른 사람들의 의견에 따릅니까?	When making group decisions, do you speak up, or go along with others?
가족과의 시간이 얼마나 중요한가요? 얼마나 많은 시간이 적당하다고 생각합니까?	How important is time with family? How much is appropriate?
학교에서 배운 가장 유용한 것들은 무엇입니까?	What were the most useful things you learned at school?
당신이 자란 지역의 문화가 당신에게 어떻게 영향을 미쳤습니까?	How were you influenced by the culture of the area you grew up in?
비판이나 조언을 얼마나 잘 받아들입니까?	How well do you receive criticism or advice?
당신을 더 강하게 또는 현명하게 만든 도전은 무엇입니까?	What challenge made you a stronger or wiser person?
이벤트, 건물 등에 몰래 들어간 적이 있습니까? 그 경험은 어땠습니까?	Did you ever sneak into an event, building, etc? How was it?
고향이 어렸을 때와 어떻게 변했습니까?	How has your hometown changed since you were young?
어렸을 때 나중에 하고 싶거나 가지고 싶었던 것을 꿈꾸었습니까?	When you were young, what did you dream of later doing or having?
과학과 기술로부터 어떤 혜택을 받았습니까?	How have you benefited from science and technology?
사후세계나 환생을 믿습니까?	Do you believe in an afterlife, or reincarnation?
남은 인생을 다른 나라에서 보내야 한다면 어떤 나라를 선택하겠습니까? 왜 그렇습니까?	You must move to another country for the rest of your life. Which country do you choose, and why?
일기나 다이어리를 쓰나요? 왜 그렇거나 왜 그렇지 않나요?	Do you keep a journal or a diary? Why, or why not?
두 번째 기회가 있다면 무엇을 다르게 하겠습니까?	What would you do differently if you had a second chance?
화를 빨리 내나요, 아니면 참는 편인가요?	"Do you have a quick temper, or a ""long fuse""?"
현재를 위해 사는 편인가요, 아니면 미래를 위해 준비하는 편인가요?	Do you live for the moment, or prepare for the future?
야외 활동을 어떻게 즐기나요?	How do you like to enjoy the outdoors?
어린이들을 보호해야 하나요, 아니면 스스로 탐험하고 배우도록 해야 하나요?	Should children be protected, or allowed to explore and learn on their own?
친구나 가족과 정치에 대해 이야기합니까?	Do you talk about politics with your friends and family?
18살 때 자신에게 어떤 조언을 해주고 싶습니까?	What advice would you give yourself at 18 years old?
언제나 어디에서 최고의 아이디어가 떠오르나요?	When or where do you have your best ideas?
휴일에 대해 어떻게 생각합니까? 즐겁나요, 스트레스받나요, 의미 있나요?	How do you feel about holidays? Are they joyful, stressful, meaningful?
사람들이 너무 쉽게 기분 상하는가요? 당신은 쉽게 기분이 상하나요?	Are people too easily offended? Are you easily offended?
끝내고 싶은 의무가 있습니까? 시간을 어떻게 다르게 사용할 수 있을까요?	Do you have obligations you want to end? What else could you do with your time?
인간이 노화를 정복할 수 있을까요?	Will humans ever conquer aging?
당신은 아침형 인간인가요, 아니면 야행성인가요? 시간이 지나면서 이것이 변했나요?	Are you more of a morning person, or night owl? Has this changed over time?
무엇을 기대하고 있습니까? 왜 그렇습니까?	What are you looking forward to? Why?
당신의 삶에 큰 영향을 미친 대화를 기억해 보세요.	Remember a conversation that significantly impacted on your life.
관심의 중심에 있는 것을 좋아합니까?	Do you like to be the center of attention?
집중력이 긴가요? 쉽게 지루해합니까?	Do you have a long attention span? Do you get bored easily?
가장 좋아하는 선생님이나 코치를 묘사해 주세요. 무엇이 그들을 뛰어나게 만들었습니까?	Describe one of your favorite teachers or coaches. What made them outstanding?
자신을 덜 의식하게 되면 무엇을 즐길 수 있을까요?	What might you enjoy doing if you were less self-conscious?
언제 가장 생기 있게 느끼나요?	When do you feel most alive?
인생 동안 하고 싶은 일의 목록이 있습니까?	"What's on your ""bucket list"" of things to do during your life?"
개를 좋아합니까, 고양이를 좋아합니까? 둘 다 좋아합니까?	Do you prefer dogs or cats? Or do you love both?
상을 받은 적이 있습니까?	Have you ever won an award?
당신이 자란 문화에 대해 무엇을 감사하게 생각합니까?	What do you appreciate about the culture you were raised in?
가장 좋아하는 계절이 있습니까? 무엇을 좋아합니까?	Do you have a favorite season? What do you like about it?
평생 동안 은하계를 여행할 수 있지만 지구로 돌아올 수 없다고 한다면, 가겠습니까?	If you could travel the galaxies for the rest of your life, but never return to Earth, would you go?
싸움을 해본 적이 있습니까? 무슨 일이 있었나요?	Have you ever been in a fight? What happened?
예술 창작을 즐기십니까? 그렇다면 무엇이 그것을 좋아하게 만듭니까?	Do you enjoy creating art? If so, what do you like about it?
사람들이 거짓말을 할 때 알 수 있습니까?	Do you tend to know when people are lying?
어울리지 않는다고 느낀 때는 언제였습니까?	When did you feel like you didn't fit in?
첫 직장은 무엇이었나요? 그것을 즐겼습니까?	What was your first job? Did you enjoy it?
운명이나 숙명을 믿습니까?	Do you believe in fate or destiny?
과거나 현재의 누구와 하루를 보낼 수 있다면 누구를 선택하겠습니까? 무엇을 할 것입니까?	You can spend a day with anyone from the past or present. Who do you choose, and what will you do?
누군가에게 맞서야 할 때는 언제입니까? 그냥 넘어가는 것이 더 나을 때는 언제입니까?	When is it appropriate to stand up to someone? When is it better to just let it go?
과거에 이해하지 못했던 자신에 대해 이제 이해하게 된 것은 무엇입니까?	What do you now understand about yourself, that you didn't understand in the past?
현재는 일반적이지 않은 쇼핑 경험을 기억하세요.	What shopping experience do you remember, that isn't common now?
경찰, 판사 등과의 기억에 남는 상호작용이 있었습니까?	Have you had any memorable interactions with police, a judge, etc?
가장 좋아하는 휴일 전통은 무엇입니까? 왜 그렇습니까?	What's your favorite holiday tradition? Why?
비디오 게임은 시간 낭비입니까? 왜 그렇거나 왜 그렇지 않습니까?	Are video games a waste of time? Why or why not?
휴대폰이나 스마트폰 이전의 삶을 기억합니까? 그때는 어떻게 달랐나요?	Do you remember life before cell phones or smartphones? How were things different?
대부분의 사람들은 비밀을 지킬 수 있습니까?	Can most people be trusted with a secret?
농담으로 다루지 말아야 할 주제가 있습니까, 아니면 유머는 항상 괜찮습니까?	Are there topics that should not be joked about, or is humor always ok?
어렸을 때 요새나 나무 집 등을 가졌습니까?	As a child, did you have a fort, or treehouse, etc?
어린 시절 집에 대한 세부 사항을 기억합니까? 무엇을 좋아했습니까?	What details do you remember about your childhood home? What did you like about it?
당신의 종교와 다른 종교를 가진 사람들을 많이 알고 있습니까?	Have you known many people with a religion other than your own?
부유하다고 느꼈던 때는 언제입니까?	When have you felt rich?
마지막으로 울었던 때는 언제입니까? 다른 사람들 앞에서 울었습니까?	When was the last time you cried? Do you cry in front of others?
도움이 필요할 때 누가 당신을 도울 것입니까?	If you needed help, who would be there for you?
당신은 한 일을 더 자주 후회합니까, 하지 않은 일을 더 자주 후회합니까?	Do you more often regret things you did, or things you didn't do?
캠핑을 즐기십니까? 좋아하는 기억이 있습니까?	Do you enjoy camping? Any favorite memories?
시간이 더 천천히 또는 빠르게 흘렀던 때는 언제입니까?	When has time seemed to pass more slowly or quickly for you?
어떤 동물이 두렵습니까? 어떤 만남이 있었나요?	What animal are you scared of? Any encounters?
잊지 못할 칭찬을 해준 사람은 누구입니까? 그들이 무엇을 말했나요?	Who gave you a compliment that you'll never forget? What did they say?
뉴스를 보거나 읽습니까? 그것이 중요합니까, 아니면 스트레스가 많은 시간 낭비입니까?	Do you watch or read the news? Is it important, or a stressful waste of time?
당신의 롤 모델은 누구였습니까? 그들로부터 무엇을 배웠습니까?	Who have been your role models? What have you learned from them?
변화가 두렵습니까, 흥미롭습니까? 둘 다인가요?	Is change scary or exciting? Is it both?
부유해지길 원합니까, 유명해지길 원합니까? 왜 그렇습니까?	Would you rather be rich or famous? Why?
일하면서 가장 즐거웠던 때는 언제였나요?	What was the most fun you've had at work?
당신은 어떤 유형의 쇼핑객입니까? 빠르게, 목록에 충실하게, 둘러보기, 충동구매?	What kind of shopper are you? Quick, stick to the list, browser, impulse buyer?
누가 또는 무엇이 당신의 유머러스한 면을 이끌어냅니까?	Who or what brings out the silly side of your personality?
가장 많이 본 영화는 무엇입니까? 왜 그것을 좋아합니까?	Which movie have you watched the most? What do you like about it?
관객 앞에서 공연, 연설, 경연 등을 한 적이 있습니까? 어땠습니까?	Have you performed, spoken, or competed in front of an audience? How was that?
더 많은 시간을 보내고 싶은 사람은 누구입니까?	Who would you like to spend more time with?
당신의 성인 생활에서 어린 시절 자신을 감동시킬 만한 것은 무엇입니까?	What about your adult life would impress your childhood self?
완벽한 하루를 묘사해 보세요.	Describe your perfect day.
물건을 사고 파는 것을 즐깁니까? 흥미로운 이야기가 있습니까?	Do you enjoy buying and selling things? Any interesting stories?
배 속에서 '나비가 날아다니는' 느낌을 받았던 때를 기억하세요. 그 느낌이 당신에게 무엇을 의미합니까?	"Remember a time you felt ""butterflies"" in your stomach. What does that feeling mean to you?"
낙관주의와 현실주의에 대해 어떻게 생각하십니까?	How do you feel about being optimistic versus being realistic?
나이가 들수록 시간이 더 빨리 지나가는 것처럼 느끼나요? 왜 그런가요?	Do the years seem to pass more quickly as we grow older? Why?
기부를 위해 백만 달러를 받았습니다. 어떤 원인을 지원하시겠습니까?	You just received a million dollars to donate to charity. Which causes will you support?
결혼은 최근 세대 동안 어떻게 변했습니까?	How has marriage changed over recent generations?
어렸을 때 어떤 무서운 괴물이나 동물에 대해 걱정했습니까?	As a child, what sort of scary monsters or animals were you worried about?
무언가를 수집한 적이 있습니까? 무엇을 즐겼습니까?	Have you ever collected anything? What did you enjoy about it?
나이 드는 것에 대해 생각합니까?	Do you think about growing old?
불친절한 사람들에게 친절하게 대해라, 그들은 그것이 가장 필요하다는 말에 대해 어떻게 생각합니까?	"It's been said ""Be kind to unkind people, they need it the most."" What do you think?"
보통 충분한 휴식을 취합니까? 왜 그렇거나 왜 그렇지 않습니까?	Are you usually well-rested? Why, or why not?
사람들이 당신에게 잘한다고 말하는 것은 무엇입니까?	What do people say you're good at?
친구나 가족이 언제 도움을 요청할 가능성이 높습니까?	When would friends and family most likely ask you for help?
어떤 일을 할 수 없다고 들었을 때 그 말을 반박한 적이 있습니까?	Have you been told you couldn't do something, and proved that person wrong?
가족이나 친구가 동의하지 않았던 결정을 한 적이 있습니까?	What decision did you make, that your family or friends didn't approve of?
쉽게 용서하나요? 용서에 대한 당신의 생각은 무엇입니까?	Do you forgive easily? What are you thoughts on forgiveness?
별명이 있었습니까? 어떻게 얻게 되었나요?	Have you ever had a nickname? How did you get it?
돈과 소유물을 모두 잃었다고 상상해 보세요. 이제 무엇을 할 것입니까?	Imagine you just lost all your money and possessions. What will you do now?
위험에 대해 어떻게 생각합니까? 두렵습니까, 흥미롭습니까, 피할 수 없습니까?	What are your thoughts on risk? Is it scary, exciting, unavoidable?
재정적으로 파산한 적이 있습니까? 기억에 남는 것이 있습니까?	Have you ever been financially broke? Do any memories come to mind?
어렸을 때 가장 좋아했던 양초는 무엇이었나요?	As a child, what were your favorite candles?
어렸을 때 쉽게 어울렸나요?	As a child, did you find it easy to fit in?
사과를 빨리 하나요, 아니면 어려운가요?	Are you quick to apologize, or is it difficult for you?
가장 좋아했던 직업은 무엇입니까? 왜 그랬습니까?	What was your favorite job, and why?
목표를 설정합니까? 만약 그렇다면 어떻게 하나요? 과거 또는 현재의 목표를 공유하시겠습니까?	Do you set goals? If so, how? Care to share a past or current goal?
믿는 원인에 돈이나 시간을 기부합니까? 기부에 대한 좋아하는 기억이 있습니까?	Do you give money or time to causes you believe in? Do you have a favorite memory of giving?
암시장에서 물건을 사고판 적이 있습니까? 무엇이고 왜 그랬습니까?	Have you bought or sold things on the black market? What and why?
영화 캐릭터 중 누구에게 영감을 받았습니까?	Which movie characters inspired you?
인생에서 가장 어려운 시기는 언제였나요? 그것이 당신에게 무엇을 가르쳤습니까?	What was the most difficult time in your life? What did it teach you?
다음 세대에게 한 가지 덕목이나 가치를 심어줄 수 있다면 무엇을 선택하겠습니까?	If you could instill one virtue or value in the next generation, what would you choose?
영혼이란 무엇입니까?	What is a soul?
돈은 얼마나 중요한가요?	How important is money?
무엇을 잘하고 어떻게 배웠습니까? 그것이 재능인가요, 연습인가요, 노력인가요?	What are you good at, and how did you learn? Was it talent, practice, hard work?
합법적이든 아니든 약물 사용에 대한 기억에 남는 경험이 있습니까?	Have you had a memorable experience using a drug, legal or otherwise?
가장 좋아하는 신화나 전설이 있습니까?	Do you have any favorite myths or legends?
술에 취한 척했던 때를 기억하세요.	Can you remember a time you pretended to be sober?
추첨, 복권 등을 당첨된 적이 있습니까? 무엇을 당첨되었나요?	Have you ever won a drawing, raffle, lottery, etc? What did you win?
사람을 잘 판단하나요?	Are you a good judge of character?
계획을 세우는 편인가요, 아니면 즉흥적인 것을 선호하나요?	Are you a planner, or prefer to be spontaneous?
아프거나 다쳤을 때 누가 돌봐 주었나요? 그때의 기억은 무엇입니까?	Who took care of you when you were sick or injured? What do you remember about that time?
체포된 적이 있습니까? 만약 그렇다면 어땠습니까?	Have you ever been arrested? If so, what was it like?
좌절감을 주지만 여전히 사랑하는 것은 무엇입니까?	What can be frustrating, but you love it anyway?
몸 밖으로 나간 것처럼 느낀 적이 있습니까?	Have you ever felt like you were outside your body?
새로운 기술이나 능력을 하나 부여받았습니다. 무엇을 선택하시겠습니까?	You have been granted one new skill or ability. What will you choose?
미루는 일이 무엇입니까?	What do you procrastinate?
무엇이 당신에게 기쁨을 줍니까?	What gives you joy?
5년 후에 죽는다는 소식을 들었습니다. 무엇을 하겠습니까?	You just learned you have five years left to live. What will you do?
어떤 법을 만들거나 변경할 수 있다면 무엇을 하겠습니까?	Imagine you can create or change any one law. What will you do?
가장 어린 시절의 기억은 무엇입니까?	What is one of your earliest memories?
인간은 우리 가장 큰 도전을 해결할 만큼 창의적인가요?	Are humans creative enough to solve our biggest challenges?
모든 비용이 지불된 상태로 어디든지 한 달 동안 여행할 수 있습니다. 어디로 갈 것이며 무엇을 할 것입니까?	You have one month to travel anywhere, all expenses paid. Where will you go, what will you do?
개인 외모(옷차림, 위생 등)는 얼마나 중요한가요?	How important is personal appearance; dress, hygiene, etc?
배우자나 중요한 다른 사람과 어떻게 만났습니까?	How did you meet your spouse or significant other?
사람들이 당신을 어떻게 기억하기를 원합니까?	How would you like people to remember you?
두려움이란 무엇입니까? 그것이 도움이 됩니까, 제한적입니까, 둘 다인가요?	What is fear? Is it helpful, limiting, both?
올리게 하는 음식은 무엇입니까? 왜 그렇습니까?	What food reminds you of home? Why?
건망증이 있습니까, 아니면 이름, 날짜 등 세부 사항을 잘 기억합니까?	Are you forgetful, or do you tend to remember details like names, dates, etc?
당신이나 다른 사람이 통제할 수 없을 정도로 웃었던 때를 기억하세요.	Remember a time you or someone else laughed uncontrollably.
받은 훌륭한 조언을 기억하세요. 그것이 어떻게 도움이 되었습니까?	Remember an excellent piece of advice you received. How has it helped you?
옷차림, 언어, 문화 등에서 유행을 따릅니까?	Do you follow fads in dress, language, culture, etc?
특히 재미있거나 의미 있는 일은 무엇입니까?	What work or activity has been particularly fun or meaningful for you?
새로운 기술과의 첫 경험을 기억합니까?	Do you remember your first experience with a new technology?
어렸을 때 소유하고 싶었던 것을 꿈꾸었습니까?	When you were a child, what was something you dreamed of owning?
학교 생활을 즐겼습니까? 좋은 학생이었습니까?	Did you enjoy your school days? Were you a good student?
자신을 개방적인 사람으로 생각합니까?	Do you consider yourself open-minded?
좋은 친구가 되기 위해 필요한 것은 무엇입니까? 좋은 친구의 예는 누구입니까?	What makes a good friend? Who is an example?
상상력이 얼마나 중요한가요? 그것이 당신의 삶에 어떤 영향을 미쳤습니까?	How important is imagination? How has it influenced your life?
무엇이 당신을 진정시킵니까?	What do you find calming?
사람들을 만나고 친구를 사귀는 데 도움이 된 활동은 무엇입니까?	What activity has helped you meet people and make friends?
어렸을 때 좋아했던 이야기나 동화는 무엇입니까?	As a child, what were some of your favorite stories or fairy tales?
얼마나 자주 카페인을 섭취합니까? 그것에 의존합니까?	How often do you drink caffeine? Do you rely on it?
어렸을 때 가장 좋아했던 활동은 무엇입니까? 그것이 당신을 어떻게 형성했습니까?	What was a favorite activity of yours while growing up? How did it shape you?
시간이 더 천천히 또는 더 빨리 흐르는 것처럼 느낄 때는 언제입니까?	When does time seem to pass more slowly or quickly for you?
원한을 품고 있습니까? 그렇다면 그것이 유용합니까, 파괴적입니까?	Do you hold grudges? If so, is it useful or destructive?
가장 좋아하는 인용구나 만트라는 무엇입니까? 왜 그것을 좋아합니까?	Do you have a favorite quote or mantra? Why do you like it?
얼마나 자주 물건을 잃습니까? 중요한 것을 잃어버린 적이 있습니까?	How often do you lose things? Have you ever lost something important?
무엇을 상상합니까?	What do you daydream about?
사용해보고 싶은 과학 소설 기술은 무엇입니까?	What science fiction technology would you love to use?
어떤 책이나 작가가 당신의 삶에 영향을 미쳤습니까? 어떻게 그랬습니까?	Which book or author has influenced your life, and how?
당신의 나라의 문화에 대해 무엇을 바꾸고 싶습니까?	If you could change something about your country's culture, what would you change?
마음과 머리가 결정에서 다를 때, 어느 쪽을 따르나요?	When your heart and your mind differ on a decision, which do you follow?
당신이 정말로 자신일 수 있는 사람은 누구인가요?	With whom can you really be yourself?
누군가에게 조언이나 정보를 주고 싶었지만 하지 않기로 한 적이 있나요?	When did you want to give someone advice or information, but decided not to?
자존감은 얼마나 중요한가요? 자존감을 어떻게 높일 수 있을까요?	How important is self-esteem? How can it be improved?
TV, 라디오, 신문 등 매체에 출연한 적이 있나요?	Have you ever been on TV, radio, in the newspaper, etc?
삶에서 어떤 이점이나 행운을 가졌나요?	What advantages or good fortune have you had in life?
당신이 직면하고 있는 도전이나 삶에서 바꾸고 싶은 것은 무엇인가요?	What's a challenge you're facing, or something you'd like to change in your life?
다른 세대들이 서로를 얼마나 잘 이해하나요?	How well do different generations understand each other?
"당신은 잘못을 인정하거나 ""모르겠다""라고 말하기 어려운가요?"	"Is it difficult to admit when you're wrong, or to say ""I don't know""?"
옛날식 신념이나 가치를 가지고 있나요?	Do you have any old-fashioned beliefs or values?
오랫동안 가지고 있었던 꿈이나 목표가 있나요?	What's a dream or goal that you've had for a long time?
협상에 능숙한가요? 협상을 즐기나요?	Are you good at negotiating? Do you enjoy it?
몇 시간 동안 빠져들 수 있는 웹사이트, 앱 또는 게임이 있나요?	What website, app or game can you get lost in for hours?
누구에게 감사한가요? 이유는 무엇인가요?	Who are you grateful to? Why?
온라인에서 배울 수 있는 것이 많아진 이 시대에 학교는 어떤 가치를 제공하나요?	With so much available to learn online, what value do schools offer?
침대를 공유하는 것에 대해 어떻게 생각하나요?	How do you feel about sharing a bed?
지루함은 괜찮은가요, 아니면 피해야 할 것인가요? 얼마나 자주 지루함을 느끼나요?	Is boredom ok, or is it to be avoided? How often are you bored?
"어린 시절의 ""짝사랑""에 대해 기억나는 것은 무엇인가요? 어떻게 감정을 표현했나요?"	"What do you remember about a childhood ""crush"". How did you show your feelings?"
최근 세대에서 육아가 어떻게 변했나요?	How has parenting changed in recent generations?
하나의 국가를 선택해 세계를 통치해야 한다면, 어느 국가를 선택할 것인가요? 이유는 무엇인가요?	You must choose one nation to rule the world. Which one will you choose? Why?
약속을 지키는 것은 얼마나 중요한가요?	How important is keeping your word?
앞으로 100년 동안 우리 세계에서 가장 큰 변화는 무엇일까요?	What will be the biggest changes in our world over the next 100 years?
다른 사람들을 잃어버린 척 하고 혼자 있고 싶었던 적이 있나요?	Have you ever pretended to lose other people, just to be alone?
반복해서 꾸는 꿈이 있나요? 그 꿈은 무엇을 의미하나요?	Have you had a recurring dream? What does it mean?
기적을 행할 수 있다는 것을 알게 되었다면 무엇을 하겠습니까?	You just learned that you can perform miracles. What will you do?
당신이 사는 곳에서는 정상적이지만 많은 곳에서 비정상적으로 보일 만한 것은 무엇인가요?	What seems normal where you live, but would be unusual in many places?
만약 당신이 유명한 연예인, 운동선수 또는 공연자가 될 수 있다면, 어떤 일을 하고 싶나요?	If you could be any kind of famous entertainer, athlete, or performer, what would you do?
가장 최근에 참석한 결혼식은?	The most recent wedding I attended?
내가 사는 집은 깔끔한가?	Is my house clean?
신이 존재한다고 믿는가? 그 증거는?	Do you believe in God? What is the evidence?
마지막으로 본 온라인 영상은?	The last online video I watched?
오늘 입은 옷 중에서 가장 새것은?	What is the newest piece of clothing I wore today?
질투 나는 사람은?	Who am I jealous of?
나를 혼동하게 만드는 것은 ___________다.	What confuses me is ___________.
나의 마지막 사랑은 ___________다.	My last love was ___________.
최근에 새로 생긴 가족이 있다면?	Do I have any new family members recently?
요즘 자주 먹는 군것질거리는?	What snacks have I been eating frequently lately?
즐겨 찾는 인터넷 사이트가 있다면?	Do I have a favorite website?
내 인생은 어느 길로 나아가고 있는가?	Which direction is my life heading?
오늘의 명언 한마디를 적어보자.	Write a quote of the day.
오늘 재미있었던 일은 ___________다.	The most interesting thing that happened today was ___________.
현재 얼마나 배가 고픈가?	How hungry am I currently?
내가 본 최악의 영화는?	The worst movie I've seen?
나를 불안하고 초조하게 만드는 질문은?	A question that makes me anxious and uneasy is?
새로 사귄 친구가 있는가?	Have I made any new friends?
오늘 내린 선택들에 만족하는가?	Am I satisfied with my choices today?
머리를 감지 않고 버틴 최장 기론은?	What is the longest time I've gone without washing my hair?
내가 지나치게 자주 사용하는 단어는?	A word I use too often is?
출퇴근에 걸리는 시간은?	How long does my commute take?
이름을 바꿀 수 있다면 무엇으로 하고 싶은가?	If I could change my name, what would I want it to be?
새롭게 알게 된 단어가 있다면?	Have I learned any new words recently?
가장 최근에 부재중 전화를 건 사람은?	Who was the most recent missed call from?
강아지와 고양이 중에 기르고 싶은 동물은?	Do I prefer dogs or cats?
캠핑 vs. 호텔 숙박?	Camping vs. hotel stay?
오늘 하지 못한 일은 무엇인가?	What didn't I do today?
최근에 아기를 안아본 적이 있는가?	Have I held a baby recently?
오늘 ___________을(를) 만들었다.	Today I made ___________.
나의 영웅은 누구인가?	Who is my hero?
지루하게 느껴지는 대화 주제는?	A boring conversation topic is?
제시간에 퇴근하는가?	Do I leave work on time?
가장 매력적이라고 생각하는 목소리는?	The most attractive voice to me is?
국경일로 정하고 싶은 날이 있다면?	Is there a day I would like to designate as a national holiday?
최근에 한 충동구매가 있다면?	Have I made an impulse purchase recently?
오늘 아침 기상은 ___________했다.	How did I wake up this morning?
나의 집중력 지수를 0~10으로 나타내보자.	Rate my focus level from 0 to 10.
마지막으로 SNS에 접속한 때는?	When was the last time I accessed social media?
오늘 당장 끝마쳐야 하는 일은?	What do I need to finish today?
현재 노력하고 있는 일은?	What am I currently working hard on?
가장 좋아하는 외식 메뉴는?	What is my favorite dining-out menu?
나의 장례식에 부르고 싶은 사람을 적어보자.	Who do I want at my funeral?
오늘 물을 얼마나 마셨는가?	How much water did I drink today?
가족을 세 단어로 표현한다면?	Describe my family in three words.
현재 나의 라이벌은 누구인가?	Who is my current rival?
현실에 안주하고 싶은가, 흥분되는 도전을 원하는가?	Do I want to stay comfortable in reality or seek exciting challenges?
현재 느끼는 행복을 1~10으로 표현한다면?	Rate my current happiness from 1 to 10.
오늘 ___________을(를) 얻었다.	Today I got ___________.
이 세상에서 가장 매력적이라고 생각하는 사람은?	Who do I think is the most attractive person in the world?
가장 최근에 관용을 베푼 경험은?	The most recent act of forgiveness I experienced?
모자람 vs. 과함?	Lack vs. excess?
변기에 앉아서 무슨 생각을 하는가?	What do I think about while sitting on the toilet?
가장 오래 통화해본 기억은?	The longest phone call memory?
건강을 위해 꼭 챙겨먹는 음식이 있다면?	Is there any food I must eat for my health?
마트에 가서 꼭 사는 물건은?	What do I always buy at the supermarket?
크리스마스로 오행시를 지어보자.	Create an acrostic poem for Christmas.
오늘 얼마나 즉흥적으로 행동했는지 1~10으로 나타낸다면?	Rate how spontaneously I acted today from 1 to 10.
가장 최근에 잃어버린 물건이 있다면?	If I lost something recently, what was it?
최근 신용카드 결제 내역에서 가장 당혹스러운 항목은?	What was the most embarrassing item on my recent credit card bill?
어디에 사는가?	Where do I live?
요즘 관심 있는 정치적 이슈는?	What political issue am I interested in these days?
사랑을 위해 저지른 가장 정신 나간 짓은?	What is the craziest thing I've done for love?
가장 최근에 나를 화나게 만든 사람은 누구인가?	Who made me angry most recently?
냉장고에 뭐가 들어 있는가?	What's in my fridge?
여권에 스탬프가 몇 개나 찍혀 있는가?	How many stamps are in my passport?
긴 머리와 짧은 머리 중에 하나를 고르라면?	If I had to choose between long hair and short hair, which one?
내가 가진 가장 값나가는 물건은?	What is the most valuable item I own?
가장 최근에 신용카드로 구입한 것은?	What was my most recent credit card purchase?
현재 가장 큰 지출을 차지하는 부분은?	What is my biggest current expense?
오늘 가장 좋았던 일은?	What was the best thing that happened today?
긴 겨울밤,오랫동안 잠겨 있는 생각은?	What are my long winter night thoughts?
지금 이 순간을 살고 있는가?	Am I living in the moment?
머릿속에서 계속 맴도는 노래는?	What song is stuck in my head?
꿈이 이루어지는 순간,누가 내 옆에 있었으면 좋겠는가?	When my dreams come true, who do I want by my side?
설득이 필요한가?	Do I need to be persuaded?
오늘 가장 생산적이었던 일은 무엇인가?	What was the most productive thing I did today?
자꾸만 놓치고 있는 것은?	What am I constantly missing?
평소 자주 인용하는 문장은?	A phrase I often quote is?
언제쯤 내 이름으로 된 책 한 권을 펴낼 수 있을까?	When will I be able to publish a book under my name?
컴퓨터 바탕화면은 무엇인가?	What is my computer wallpaper?
나의 지난 한 해를 영화로 만든다면 제목은?	If my past year was made into a movie, what would the title be?
나만의 착각에 불과했던 것은?	What was just my misconception?
독립이라는 단어를 들으면 어떤 느낌이 드는가?	What feeling do I get when I hear the word 'independence'?
나의 서른은 어떤 모습일까?	What will I look like at thirty?
귀가 닳도록 듣고 있는 말이 있다면?	Is there something I hear so often it's tiresome?
지금 사랑하고 있는가?	Am I in love right now?
한 달쯤 살아보고 싶은 곳은?	Where would I like to live for about a month?
친구들 중에 데미안이 있는가?	Do I have a friend like Damien?
해피엔딩으로 막을 내린 사건은?	What event ended happily?
나의 베스트 프렌드를 세 단어로 표현해보자.	Describe my best friend in three words.
내 안에,또 다른 내가 살고 있는가? 소개해보라.	Is there another self living inside me? Introduce it.
현재 프로필 사진은 무엇인가?	What is my current profile picture?
학생 식당에 얼마나 자주 가는가?	How often do I eat at the student cafeteria?
새 학기에 가장 힘들 것 같은 수업은?	Which class seems the most difficult this new semester?
지금 어디에 있는가? 왜 거기에 있는가?	Where am I right now? Why am I there?
사랑받고 있는가?	Am I loved?
오늘 하루를 짧은 시로 표현해보자.	Express today in a short poem.
누구에게 마음을 들켰는가?	Who has found out about my feelings?
지금 무슨 생각을 하는가?	What am I thinking right now?
호기심이 가는 새로운 사람은 누구인가?	Who is the new person I am curious about?
가장 달콤한 유혹은?	What is the sweetest temptation?
가장 앞서가는 선배는 누구인가?	Who is the most ahead-of-the-curve senior?
내 인생의 첫 직장은 어디일 것 같은가?	Where is my first job likely to be?
나는 무엇에 목이 마른가?	What am I thirsty for?
만끽했던 승리는?	What victory have I savored?
내년에도 나는 여기에 있을까?	Will I still be here next year?
현재 가장 고전하고 있는 과제는 무엇인가?	What is my most challenging task right now?
누구도 예상치 못한 일을 성공시킨 사람은?	Who accomplished something no one expected?
지금 장안의 화제는 무엇인가?	What is the current hot topic?
가장 즐겨 쓰는 앱(app)은 무엇인가?	What app do I use the most?
무엇이든 좋다. 특허를 내고 싶은 아이디어가 있는가?	Do I have any idea for a patent?
중요한 시험이나 인터뷰가 곧 있는가? 준비되었는가?	Do I have an important exam or interview soon? Am I prepared?
치열한 경쟁이 예상되는 것은?	What is expected to be fiercely competitive?
가장 마지막으로 춤을 춘 것은 언제인가?	When was the last time I danced?
도서관 대출 1순위 책은 무엇인가?	What is the top book on my library checkout list?
좀 더 연구해야 할 대상은?	What subject needs more research?
가장 흥미로웠던 성공 스토리는?	What is the most interesting success story?
20대에는 누구나 혁명가가 된다. 나도 그런가?	Everyone becomes a revolutionary in their twenties. Am I like that?
몇 살까지 살 것 같은가? 그 이유는?	How old do I think I will live to be? Why?
나의 가장 큰 단점은 무엇인가?	What is my biggest flaw?
최고치를 경신한 기록은?	What record have I broken?
첫눈에 반했던 것은?	What was love at first sight?
가장 열심히 살고 있는 사람은?	Who is living the hardest?
기어코 만나야 하는 사람이 있는가?	Is there someone I absolutely must meet?
가장 최근에 강의실에 가면서 무슨 생각을 했는가?	What was I thinking on my way to the lecture hall most recently?
어디에서 공부하는가?	Where do I study?
어젯밤에 뭘 했는가?	What did I do last night?
언제나 운이 따르는 사람은 누구인가? 나는 어떤가?	Who is always lucky? How about me?
현재 나를 불안하게 하는 것이 있는가?	Is there something making me anxious right now?
마지막으로 해 지는 바다를 본 건 언제인가?	When was the last time I saw the sunset over the sea?
지난 3개월 동안 구입한 것 중에 가장 비싼 물건은?	What was the most expensive thing I bought in the past three months?
오늘 가장 많은 시간을 함께한 사람은 누구인가?	Who did I spend the most time with today?
오늘 떠올린 사람들의 이름을 전부 적어보자.	Write down all the names of people I thought about today.
새해 들어 눈에 띄게 달라진 사람은?	Who has noticeably changed since the new year began?
슬플 때 누구에게 전화하는가?	Who do I call when I'm sad?
가장 최근에 직접 손으로 쓴 메모의 내용은?	What was the most recent note I wrote by hand about?
내게 지금 필요한 것은 기업가정신인가, 장인정신인가? 둘 다 아니라면 어떤 정신?	Do I need an entrepreneurial spirit or an artisan spirit right now? If neither, then what kind of spirit?
여전히 불편하고 어색한 사람은? 그 이유는?	Is there still someone I feel uncomfortable and awkward with? Why?
박수를 받은 프레젠테이션은?	When was the presentation I received applause for?
진리를 찾았는가?	Have I found the truth?
거짓으로 판명된 것은?	What has been proven to be false?
격하게 공감이 가는 일이나 사람은?	What is something or someone I deeply empathize with?
절대 룸메이트로 받아들일 수 없을 것 같은 친구는?	Which friend could I never accept as a roommate?
올해 내게 강력한 영향력을 끼치고 있는 세 사람은?	Who are the three people having the most significant impact on me this year?
어떤 모임에 가장 많이 참석하고 있는가?	What type of gathering do I attend the most?
지금 내 백팩에는 무엇이 들어 있는가?	What's in my backpack right now?
글쓰기 실력은 점점 향상되고 있는가?	Is my writing skill improving?
버스나 지하철에서 만난 가장 인상적이었던 사람은?	Who was the most impressive person I met on the bus or subway?
나의 가장 강력한 자기소개서 한 줄은?	What is my strongest one-liner for my resume?
친구들에게 추천해주고 싶은 다큐멘터리는?	What documentary would I recommend to my friends?
언제 미친 존재감을 드러냈는가?	When did I make a significant presence felt?
최근에 남몰래 한 일은?	What is something I did secretly recently?
만취해 필름이 끊긴 적이 있는가? 기분이 어땠는가?	Have I ever blacked out from drinking? How did I feel?
내 열정에 불을 당겨준 것은?	What has ignited my passion?
세상은 어떤 인재를 원할까?	What kind of talent does the world need?
나의 금융지식 수준을 1~10단계로 나눌 때, 어느 단계에 있는가?	On a scale of 1 to 10, where does my financial knowledge fall?
한 우물을 파야 할까?	Should I focus on one thing intensely?
내게 너무 과분했던 것은?	What was too good for me?
맞서 싸워 얻어내야 할 것은?	What should I fight to obtain?
벽에 부딪친 느낌이 들었던 적은?	Have I ever felt like I hit a wall?
부치지 못한 편지가 있는가?	Do I have an unsent letter?
나의 헤어스타일은?	What is my hairstyle?
시위에 참석한 적 있는가?	Have I ever attended a protest?
가장 마음에 드는 철학자는?	Who is my favorite philosopher?
아침형 인간인가,저녁형 인간인가?	Am I a morning person or a night person?
나의 미션은 무엇인가?	What is my mission?
열심히 일해보고 싶은 비영리조직이 있다면?	Is there a non-profit organization I want to work hard for?
끝내 화해하지 못한 사람은? 영원히 그럴 것 같은가?	Is there someone I never reconciled with? Will it be like that forever?
나의 악취미가 있다면?	If I have a bad hobby, what is it?
용한 점쟁이를 만난다면 꼭 물어보고 싶은 한 가지는?	What is one thing I would ask a fortune teller?
전략을 바꿔야 할까?	Should I change my strategy?
정장을 차려 입은 적은 언제인가?	When was the last time I wore formal attire?
요즘 내게 쾌감을 주는 것은?	What currently gives me pleasure?
내 미래에 영향을 끼칠 것 같은 글로벌 트렌드는?	What global trend might influence my future?
좋은 흐름을 이어가고 있는 것은?	What is continuing well?
가장 아쉬웠던 순간은?	What was the most regrettable moment?
첫사랑은 지금 어디서 무엇을 하고 있을까?	Where is my first love now, and what are they doing?
작년 여름에 있었던 가장 멋진 일은?	What was the best thing that happened last summer?
현재 가장 말도 안 되는 유행은?	What is the most ridiculous trend right now?
확실하게 검증된 것은 무엇인가?	What is the most verified fact?
버리고 나서 후회한 것은?	What do I regret discarding?
가장 미스터리한 사람은?	Who is the most mysterious person?
이번 주에 너무 무리했던 일은?	What did I overdo this week?
요즘 꼬리에 꼬리를 무는 생각은?	What are my current spiraling thoughts?
위협감을 느낀 적이 있었는가?	Have I ever felt threatened?
입맛을 북돋는 음식은?	What food stimulates my appetite?
오매불망 기다렸던 메시지는 도착했는가?	Did the long-awaited message arrive?
내가 꿈꾸는 게스트하우스의 이름을 지어보자.	What would I name my dream guesthouse?
최고의 반전은 무엇이었나?	What was the best twist?
소설로 펴내도 될 주변의 러브 스토리가 있다면?	Is there a love story around me worthy of a novel?
이번 달에 있었던 가장 당혹스러운 일은?	What was the most embarrassing thing this month?
눈물은 왜 짤까?	Why are tears salty?
돈이 정말 아까웠던 적은?	When was money really wasted?
적과 함께 살아가는 나만의 방법은?	How do I live with my enemies?
가성비 만점인 것은?	What has the best value for money?
일주일에 라면을 평균 몇 번 먹는가?	How often do I eat ramen in a week on average?
(아직) 아무한테도 말하지 않은 것이 있다면?	Is there something I've never told anyone?
나의 삶은 민주적 절차를 중시하는가?	Does my life emphasize democratic procedures?
주사위를 던져야 할 일이 있다면?	Do I have to roll the dice for something?
도전해보고 싶은 익스트림 스포츠는?	What extreme sport do I want to try?
오늘 하루,쾌조의 스타트를 끊었는가?	Did I start the day with a positive vibe?
두 번 이상 읽은 책은 무엇인가? 그 이유는?	What book have I read more than twice? Why?
내 전공분야에 큰 도움을 주는 것이나 사람이 있다면?	Is there something or someone that significantly helps me in my field of study?
유용한 정보를 주로 어디에서 얻는가?	Where do I mainly get useful information?
건망증 때문에 난감했던 적은?	When has forgetfulness caused me a problem?
비가 오면 생각나는 것은?	What does rain make me think of?
일주일에 몇 번 혼자서 밥을 먹거나 술을 마시는가?	How often do I eat or drink alone in a week?
어떤 일에 응모하거나 지원해본 경험은?	Have I ever applied for something or entered a contest?
부모님이 아시면 걱정하실 일이 있는가?	Is there something my parents would worry about if they knew?
모교에서 강연을 할 기회가 있다면,그 주제는?	If I had the chance to give a lecture at my alma mater, what would the topic be?
30분 동안 누구든 될 수 있다면,누가 되고 싶은가?	If I could be anyone for 30 minutes, who would I choose?
최근에 떠올린 가장 기발한 생각은?	What is the most brilliant idea I've had recently?
휴학기간을 가장 성공적으로 보낸 사람은 누구인가?	Who spent the most successful gap year?
최근에 직접 만든 것은 무엇인가?	What have I made recently?
뭔가 축하할 일이 있는가?	Is there something to celebrate?
가장 시원한 곳은 어디인가?	Where is the coolest place?
기성세대의 가장 큰 문제점은 뭘까?	What is the biggest problem with the older generation?
가장 최근에 병원에 다녀온 이유는?	Why did I go to the hospital most recently?
울컥했던 순간은?	What was a moment that made me tear up?
절대 용서할 수 없는 것은?	What is something I can never forgive?
나를 미궁에 빠뜨린 것은?	What has left me puzzled?
여행지에서 생긴 가장 놀라운 일은?	What was the most surprising thing that happened on a trip?
꼭 따고 싶은 자격증이 있다면?	What certification do I really want to obtain?
나에게 없으면 안 되는 것은 무엇인가?	What can I not live without?
최근에 끊은 것은?	What have I recently given up?
약속과 다짐들은 잘 지켜지고 있는가?	Are my promises and commitments being kept?
지금까지의 올 한해에 대해 한 문장으로 표현해보자.	Describe this year in one sentence so far.
지금 가장 멀리 있는 친구는 누구인가?	Who is the friend farthest away from me right now?
전화위복이 된 일은?	What was the silver lining in a bad situation?
작년 이맘때보다 가장 많이 바뀐 것은 무엇인가?	What has changed the most since this time last year?
최근에 딱 들어맞은 법칙은 무엇인가?	What rule has proven to be accurate recently?
올 여름,심장이 쫄깃해졌던 일은?	What made my heart race this summer?
소리 없이 강한 친구는?	Who is the quiet but strong friend?
가장 최근에 비행기를 탄 적은 언제인가?	When was the last time I took a flight?
선두로 치고 올라가야 하는 일은?	What is something I need to take the lead on?
현재 내 마음 상태를 다섯 단어로 나타내보자.	Describe my current state of mind in five words.
넋을 잃고 바라본 예술작품은?	What art piece left me spellbound?
도박이나 다름없었던 일은?	What was a near gamble?
용기를 내어 보낸 메일이나 편지는?	What is a letter or email I sent with courage?
오늘 기준으로 통장 잔액이 얼마인가?	What is my current bank balance?
역사에서 바로 잡아야 할 것이 있다면?	What should be corrected in history?
지금껏 최고의 협상은 무엇이었나?	What has been my best negotiation so far?
내 마음을 알아주었으면 하는 사람은?	Who do I wish would understand me?
기록으로 남겨야 할 일은?	What should be recorded?
달력에 동그라미 쳐진 날의 의미는?	What is the significance of a circled date on my calendar?
가장 최근에 예약한 것은?	What was the most recent thing I booked?
내가 특별한 이유는 무엇인가?	Why am I special?
친구 때문에 새롭게 생긴 흥밋거리는?	What new interest did a friend spark in me?
최근 한 달 동안 가장 자주 방문한 곳은?	Where have I visited the most in the past month?
삶이 더 스마트해진 것 같은가?	Has life become smarter?
사놓고 아직 한 번도 안 쓴 것이 있다면?	What have I bought but never used?
종주해보고 싶은 산이나 트레킹 코스는?	What mountain or trekking course do I want to complete?
최근에 다시 시작한 것은?	What have I recently restarted?
가장 지혜로운 사람은 누구인가?	Who is the wisest person I know?
솔직하게 인정해야 하는 것은?	What must I honestly admit?
놓치기엔 정말 아까운 기회는?	What opportunity is too good to miss?
마르고 닮도록 쓰고 있는 것은?	What do I keep writing over and over?
요즘 가장 많이 검색하는 키워드는?	What are my most frequently searched keywords?
뜬눈으로 밤을 새운 적이 있는가?	Have I ever stayed up all night?
비밀리에 진행하고 있는 프로젝트는?	What is my secret project?
나 자신에게 말을 걸어보자.	What would I say to myself?
대학생이어서 가장 좋은 점이 있다면?	What is the best thing about being a college student?
나를 자꾸 긴장시키는 것은?	What keeps making me tense?
내가 최선의 능력을 발휘하도록 이끌어주는 사람은?	Who helps me perform at my best?
새 학기의 시작은 만족스러운가?	Am I satisfied with the start of the new semester?
내일이 생의 마지막 날이라면 오늘 무엇을 하겠는가?	If tomorrow were my last day, what would I do today?
요즘 가장 진지했던 밤은?	What was my most serious night recently?
예고도 없이 사라진 것은?	What disappeared without warning?
전율을 느꼈던 일은?	What was a moment that gave me chills?
참된 스승을 찾았는가?	Have I found a true teacher?
깊이 추모해야 할 일이 있다면?	Is there something I deeply mourn?
초등학교 2학년에게 해주고 싶은 조언은?	What advice would I give to a second grader?
요즘 핫(hot)한 것은?	What is currently hot?
방에 어떤 액자가 걸려 있는가?	What kind of frame is hanging in my room?
극진한 대우를 받은 적은 언제인가?	When did I receive the most considerate treatment?
언젠가 꼭 다시 만날 것 같은 사람은?	Is there someone I feel I will definitely meet again someday?
요즘 대화가 즐거운 사람은?	Who is enjoyable to talk to these days?
공부에 활력을 주는 것은?	What gives me energy to study?
잊지 못할 추억을 만들고 있는가?	Am I making unforgettable memories?
유레카!를 외쳤던 순간은?	When did I have an Eureka! moment?
가장 좋아하는 TV 프로그램은?	What is my favorite TV show?
가장 최근에 받은 상이나 상품은?	What is the most recent award or prize I've received?
결정적인 순간에 나를 살린 한 마디는?	What was the phrase that saved me at a critical moment?
마지막으로 운동한 것은 언제인가?	When was the last time I exercised?
누가 나를 기다려주면 좋겠는가?	Who do I wish would wait for me?
적극 나서서 변호해주고 싶은 사람은?	Who do I want to actively defend?
10대 시절 해보지 않아 후회되는 것은?	What do I regret not doing in my teenage years?
잃어버린 걸 다시 찾았는가?	Did I find something I lost?
반면교사로 삼아야 할 일은?	What should I learn from a bad example?
금요일 밤을 보내는 최고의 방법은?	What is the best way to spend a Friday night?
돈 없이도 편하게 만날 수 있는 친구는?	Who is a friend I can meet comfortably without money?
아주 멀리 있어 다행인 것은?	What is something I'm glad is very far away?
이번 주에 두려운 일이 있는가?	Is there something I'm afraid of this week?
친구와 맞바꾸고 싶은 것은?	What do I want to trade with a friend?
단호하게 거절한 것은 무엇인가?	What have I firmly refused?
예순 살이 되었을 때 나는 어디에 살고 있을까?	Where will I live when I am sixty?
모든 게 완벽했던 일은?	What was the moment when everything was perfect?
가장 비싼 대가를 치른 일은?	What did I pay the highest price for?
완전히 엉뚱한 것을 선택했던 경험은?	What was a completely unexpected choice?
지금 내게 필요한 건 자유인가,소속감인가?	Do I need freedom or a sense of belonging right now?
가장 오랫동안 간직하고 있는 선물은?	What is the gift I've kept the longest?
일어날 일은 기어코 일어난다. 그랬던 경험은?	What was an inevitable event?
최근 다른 학교에 간 적이 있는가?	Have I recently visited another school?
창업을 한다고 해보자. 1순위로 영입해야 할 사람은 누구인가?	If I start a business, who is the first person I should hire?
어디서 마시는 커피를 가장 좋아하는가?	Where do I prefer to drink coffee?
오늘 ____________시에 일어났다. 그 이유는?	I woke up at ____________ this morning. Why?
천천히 답을 찾아야 할 일은?	What do I need to take my time to find an answer for?
평범한 사람이 부자가 될 수 있는 방법은 뭘까?	What is a way for an ordinary person to become rich?
가장 많은 사람 앞에 서본 경험은?	What is the largest audience I've stood in front of?
오지랖이 가장 넓은 사람은?	Who is the most meddlesome person I know?
A+를 받은 리포트는?	What report did I get an A+ on?
사소한 것에 목숨 걸고 있지는 않는가?	Am I getting hung up on trivial things?
가장 큰 배신감을 느꼈던 적은?	When did I feel the greatest betrayal?
재테크에 관심이 있는가? 그렇거나 그렇지 않은 이유는?	Am I interested in financial management? Why or why not?
모두가 숨을 죽였던 순간은?	What was a moment when everyone held their breath?
1분이 한 시간처럼 느껴졌던 때는?	When did one minute feel like an hour?
썼다,지웠다 하는 것은?	What do I keep writing and erasing?
동기들 중 가장 존경스러운 인물은?	Who is the most respectable peer among my classmates?
낮술을 마신 적 있는가? 어땠는가?	Have I ever drunk during the day? How was it?
보완해야 할 것은?	What needs improvement?
최고의 벼락치기는?	What was the best cramming session?
오늘 하루에 관해 딱 한 가지를 바꿀 수 있다면 무엇을?	If I could change just one thing about today, what would it be?
통째로 삭제하고 싶은 흑역사가 있다면?	Do I have an embarrassing moment I want to erase completely?
11월은 내 삶에 어떤 의미인가?	What does November mean to my life?
나를 환하게 비추고 있는 것은?	What is currently shining a light on me?
뜻밖의 사람을 만났는가?	Have I met someone unexpected?
노숙의 경험이 있는가?	Have I ever been homeless?
세 가지 소원은?	What are my three wishes?
부모님에게 가장 최근에 받은 문자는?	What was the most recent text from my parents?
결혼은 몇 살쯤 할 것 같은가?	When do I think I'll get married?
소문에 휘말린 적은?	Have I ever been caught in a rumor?
기념 티셔츠가 몇 벌 있는가?	How many commemorative t-shirts do I have?
요즘 자꾸만 눈길이 가는 것은?	What keeps catching my eye these days?
현재 가장 관심이 많은 과목은?	What is my current favorite subject?
미루고 싶은 일이 있는가?	Is there something I want to procrastinate on?
어지러운 마음을 편하게 해주는 풍경은?	What view calms my troubled mind?
질투에 눈이 멀었던 적은?	When was I blinded by jealousy?
내게 근사한 저녁을 산 사람은?	Who bought me a nice dinner?
원점으로 돌아간 것은?	What has returned to the starting point?
오늘 ____________을(를) 입었다.	Today I wore ____________.
우리 가족을 세 단어로 표현한다면?	Describe my family in three words.
내 삶에 영감을 주는 아티스트는 누구인가?	Who is an artist that inspires me?
가장 최근에 위험을 무릅쓴 일은 무엇인가?	What is the most recent risk I took?
오늘 내게 더 많이 필요했던 것은?	What did I need more of today?
계속 궁금한 이야기가 있는가?	Is there a story I keep wondering about?
아래를 내려다보자. 무엇인 보이는가?	Look down. What do I see?
현재 느끼는 행복을 1~10으로 표현한다면?	Rate my current happiness from 1 to 10.
스토킹을 당했거나 목격한 경험이 있는가?	Have I ever been stalked or witnessed stalking?
카르페디엠 정신을 실천하고 있는가?	Am I practicing the Carpe Diem spirit?
열렬하게 지지받은 경험은?	When was I fervently supported?
읽다가 포기한 책은?	What book did I give up on reading?
잘 되는 나와 안 되는 나,어느 쪽에 먹이를 주고 있는가?	Am I nurturing the successful me or the failing me?
올해 마무리되어서 속이 시원한 일은?	What has been completed this year, making me feel relieved?
내년에 유의해야 할 건강은?	What health issue should I watch out for next year?
전공을 바꿀 수 있다면?	If I could change my major, what would I choose?
소중한 것을 먼저 하고 있는가?	Am I prioritizing important things?
5년 안에 사라질 것 같은 직업은?	What job might disappear in five years?
요즘 나의 컨디션은?	How is my current condition?
기다려지는 송년 파티는?	What year-end party am I looking forward to?
오늘 하루를 다섯 단어로 표현해보자.	Describe today in five words.
대학 졸업 후 새로운 도시로 간다면 어디로?	If I move to a new city after graduating, where would it be?
재충전해야 할 것은?	What needs recharging?
나의 플랜 B는 무엇인가?	What is my Plan B?
내가 아는 가장 높은 위치에 있는 사람은?	Who is the highest-ranking person I know?
어떤 분야의 최고가 되고 싶은가?	What field do I want to be the best in?
생긴 것과는 완전 딴판인 사람은?	Who is a person completely different from their appearance?
가장 그럴듯한 핑계나 변명은?	What is the most plausible excuse?
나를 위해 짧은 기도문을 써보자.	Write a short prayer for myself.
올해 가장 즐거운 마음으로 한 선물이 있다면?	What was the most enjoyable gift I gave this year?
지금 당장 누군가를 포옹할 수 있다면?	If I could hug someone right now, who would it be?
이 다이어리북을 펼친 순간,가장 먼저 떠오르는 것은?	What comes to mind first when I open this diary book?
올해 내 삶에 가장 기여한 사람은 누구인가?	Who contributed the most to my life this year?
소중한 사람들에게 한 마디 해보자.	Say something to the precious people in my life.
올해를 완주한 나를 축하해보자.	Celebrate myself for finishing this year.
배가 있다면 이름을 무엇으로 지어주고 싶은가?	If I had a boat, what would I name it?
소설 속 인물 중 실제로 만나면 가장 지루할 것 같은 인물은?	Who is a novel character that would be boring to meet in real life?
여태까지 먹어 본 최악의 요리는?	What was the worst dish I've ever eaten?
최악의 광고는? 그 이유는?	What is the worst commercial? Why?
마법에 가까운 것이 있다면 무엇인가?	What is something magical?
내가 가지고 있는 재능 중 가장 쓸모없는 것은?	What is the most useless talent I have?
10분 늦게 도착하기 vs. 20분 미리 도착하기?	Arriving 10 minutes late vs. 20 minutes early?
한 가지를 무조건 잃게 된다면 돈 vs. 사진?	If I had to lose one thing, money vs. photos?
평생 짜증나는 사람들한테 둘러쌓여 살기 vs. 평생 혼자 살기?	Living surrounded by annoying people vs. living alone forever?
SNS 금지 vs. TV/영화 금지?	Banning social media vs. banning TV/movies?
투명인간 되기 vs. 날기?	Becoming invisible vs. flying?
에어콘이 없는 세상 vs. 히터가 없는 세상?	A world without air conditioning vs. a world without heating?
좋은 목소리 vs. 좋은 말솜씨?	Having a good voice vs. having good speaking skills?
달에 가보기 vs. 화성에 가보기?	Visiting the Moon vs. visiting Mars?
눈썹이 한 쪽만 남았다 vs. 눈썹이 아예 없다? (화장 불가)	Having one eyebrow vs. having no eyebrows? (No makeup allowed)
무제한 커피 vs. 무제한 맥주?	Unlimited coffee vs. unlimited beer?
천재 수학자 vs. 천재 화가?	Genius mathematician vs. genius painter?
내가 알고 있는 가장 재밌는 농담은?	What is the funniest joke I know?
보이지 않는 것 중 사람들 눈에 보이기를 바라는 것은?	What is something invisible that I wish people could see?
씨리얼은 국인가?	Is cereal a soup?
코끼리를 쓰러뜨리기 위해 몇 마리의 닭이 필요할까?	How many chickens would it take to bring down an elephant?
핫도그는 샌드위치인가?	Is a hot dog a sandwich?
친구가 없는 삶 vs. 돈이 없는 삶?	A life without friends vs. a life without money?
내가 자라난 도시는?	What city did I grow up in?
엄마를 닮았나 아빠를 닮았나?	Do I look more like my mom or dad?
가장 좋아하는 배우는?	Who is my favorite actor?
가장 좋아하는 가수는?	Who is my favorite singer?
가장 좋아하는 스포츠는?	What is my favorite sport?
강아지? 고양이?	Dog? Cat?
가장 무서워하는 동물은?	What is the animal I fear the most?
낙서를 얼마나 자주 하는가?	How often do I doodle?
가장 최근에 들은 칭찬은?	What was the most recent compliment I received?
가지고 있는 습관 3가지는?	What are three habits I have?
나는 세심한 편인가?	Am I a meticulous person?
언제 노래를 부르는가?	When do I sing?
사람을 얼마나 믿는가?	How much do I trust people?
모르는 게 약인가? 왜 그런가?	Is ignorance bliss? Why?
이름을 바꿀 수 있다면 무엇으로 바꾸고 싶은가?	If I could change my name, what would I change it to?
약점을 한 가지 없앨 수 있다면 무엇을 없애겠는가?	If I could eliminate one weakness, what would it be?
나를 놀랍게 하는 것은?	What surprises me?
나만이 가지고 있는 설득의 기술이 있다면?	What is my unique persuasive technique?
다른 사람에게서는 쉽게 볼 수 없는 나만의 특성은?	What is my characteristic that is rare in others?
친구관계 스타일은? 좁고 깊은 편? 넓고 얕은 편?	What is my friendship style? Narrow and deep? Broad and shallow?
신체적인 한계에 도달했던 일은?	When have I reached my physical limit?
갈등을 피하는 편인가?	Do I tend to avoid conflict?
마지막으로 새로운 것에 도전한 시점은 언제인가?	When was the last time I tried something new?
나에게만 3년이 주어진다면 그 기간동안 무엇을 하고 싶은가?	If I had three years just for myself, what would I do during that time?
내가 가르칠 수 있는 것 한 가지는?	What is one thing I can teach?
80살이 된다면 무엇이 가장 중요해질까?	What will be most important when I am 80 years old?
나를 웃게 만드는 것은?	What makes me laugh?
음식을 훔쳐서 굶고 있는 아이를 먹이는 것은 그른 행위일까?	Is it wrong to steal food to feed a starving child?
내가 절대로 어기지 않을 도덕적 신념 세 가지는?	What are three moral beliefs I will never break?
돈으로 살 수 없는 것은?	What can't be bought with money?
천국이 존재한다면 어떤 모습일까?	If heaven exists, what would it look like?
사람을 아름답게 하는 것은?	What makes a person beautiful?
사랑은 어떤 느낌인가?	What does love feel like?
이번 주에 나를 웃게한 것은?	What made me laugh this week?
나에게 가장 동기부여가 되는 것은?	What motivates me the most?
사랑이 지속되게 하는 것은 무엇인가?	What keeps love going?
내 인생에서 가장 부족한 것은?	What is most lacking in my life?
가장 동경하는 연예인은?	Who is the celebrity I admire the most?
전 세계가 나를 30초 동안 주목한다면 무슨 말을 할까?	If the whole world paid attention to me for 30 seconds, what would I say?
냉장고 안에 무엇이 있는가?	What is in my refrigerator?
인간의 발명품을 한 가지 없앨 수 있다면 무엇을 없애겠는가?	If I could eliminate one human invention, what would it be?
하룻동안 하나의 단어만 말할 수 있다면 어떤 단어를 말하겠는가?	If I could only say one word for a day, what word would I choose?
좋아하는 친구의 특성은?	What is a characteristic I like in my friends?
가장 좋아하는 소리는?	What is my favorite sound?
자발적으로 한 말 중 가장 바보 같았던 말은?	What is the dumbest thing I have ever said voluntarily?
배워보고 싶은 언어가 있다면?	What language would I like to learn?
가장 좋아하는 음악 장르는?	What is my favorite genre of music?
친구들과 가고 싶은 여행지는?	Where would I like to travel with my friends?
나를 맛에 비유한다면 무슨 맛인가?	If I were a flavor, what would I be?
말을 하지 않고 얼마나 오래 버틸 수 있는가?	How long can I go without talking?
당장 갖고 싶은 세 가지가 있다면?	What are three things I want right now?
오늘 처음 시도해본 활동이 있다면?	What was something new I tried today?
오늘 나는 ___________이(가) 좀 더 필요했다.	Today I needed ___________ more.
오늘 있었던 일 중에서 지우고 싶은 기억이 있다면?	If there is something from today I want to erase, what is it?
내일 무엇을 할 계획인가?	What do I plan to do tomorrow?
지금 밖의 날씨는 ___________다.	What is the weather outside right now?
어제 몇 시에 잠자리에 들었는가?	What time did I go to bed last night?
오늘 하루를 동물에 비유한다면? 그 이유는 무엇인가?	If today was an animal, what would it be? Why?
오늘 하루 벌어진 일 중에서 바꾸고 싶은 게 있다면?	What is something from today I want to change?
오늘 있었던 일 중 후회하는 것은?	What do I regret about today?
오늘 나의 하루는 짠맛인가,	Is my day salty today?
생일선물로 절대 받고 싶지 않은 것이 있다면?	What is something I never want as a birthday gift?
지금 당장 사고 싶은 것은?	What do I want to buy right now?
오늘 하루를 어떻게 시작했는가?	How did I start my day?
가장 최근에 말다툼을 한 적이 있는가? 무슨 일 때문이었나?	Did I have a recent argument? What was it about?
오늘 커피를 몇 잔 마셨는가?	How many cups of coffee did I have today?
지속적으로 하고 있는 운동이 있는가?	Is there a sport I do regularly?
오늘 평소와 달랐던 점은 ___________다.	What was different about today compared to usual?
가장 좋아하는 옷은?	What is my favorite piece of clothing?
최근에 가본 새로운 곳은?	What new place have I visited recently?
가장 좋아하는 TV 프로그램은?	What is my favorite TV show?
최근에 기분 좋은 대화를 나눈 사람의 이름을 적어보자.	Write down the name of the person I had the most pleasant conversation with recently.
평소 피하려고 하는 것은 무엇인가?	What do I usually try to avoid?
가장 아끼는 신발은?	What are my most cherished shoes?
여름이 좋은가,	Do I prefer summer?
현재 읽고 있는 글이나 책이 있다면?	What am I currently reading?
계속 머릿속에 맴도는 노래가 있다면?	What song is stuck in my head?
다음에 여행하고 싶은 곳은 어디인가?	Where do I want to travel next?
마지막으로 읽은 책은?	What was the last book I read?
가장 편안하게 느껴지는 장소는?	Where do I feel most comfortable?
일요일 오전을 행복하게 보내는 나만의 비법은?	What is my secret to a happy Sunday morning?
오늘 읽은 가장 인상적인 글귀는?	What was the most impressive quote I read today?
가장 좋아하는 단어가 있다면?	What is my favorite word?
내 이름으로 삼행시를 지어보자.	Create an acrostic poem with my name.
나에게 주고 싶은 선물이 있다면?	What gift do I want to give myself?
로또에 당첨되면 가장 먼저 하고 싶은 일은?	What is the first thing I want to do if I win the lottery?
가장 좋아하는 액세서리는?	What is my favorite accessory?
가장 자신 있게 만들 수 있는 요리는?	What dish am I most confident in making?
최근 꾼 꿈 중에 인상적인 것은?	What was the most impressive dream I've had recently?
몹시 기다려지는 일이 있는가?	Is there something I'm eagerly waiting for?
마지막으로 본 TV 프로그램은?	What was the last TV show I watched?
마지막으로 가본 공연이나 콘서트는?	What was the last concert or performance I attended?
(지금 이 순간) 가장 좋아하는 단어는?	What is my favorite word at this moment?
마지막으로 들은 노래는?	What was the last song I listened to?
___________이(가) 나를 웃게 했다.	___________ made me laugh.
나에게 없어는 안 되는 인류의 발명품은?	What is an indispensable human invention for me?
오늘 하루 즐거웠는가? 그 이유는?	Was today enjoyable? Why?
오늘 나를 가장 기쁘게 한 소식은 무엇인가?	What news made me happiest today?
오늘 새롭게 알게 된 사실을 적어보자.	What new fact did I learn today?
오늘 해결한 문제를 한 가지만 적어보자.	Write down one problem I solved today.
지금 당장 전화를 걸고 싶은 사람은?	Who do I want to call right now?
내 인생을 영화로 만든다면 주인공 역은 누구로 하고 싶은가?	If my life were a movie, who would play me?
무슨 요일을 가장 좋아하는가? 그 이유는?	What is my favorite day of the week? Why?
나는 오늘 ___________을(를) 제거했다.	Today I eliminated ___________.
오늘 나에게 동기를 부여해준 일은?	What motivated me today?
내일 어디든 여행할 수 있다면 가장 가고 싶은 곳은?	If I could travel anywhere tomorrow, where would I go?
하루의 휴가가 주어진다면 무엇을 하고 싶은가?	What would I do with a day off?
오늘 감사하게 생각하는 일은?	What am I grateful for today?
금요일 밤을 보내는 나만의 가장 행복한 방법은?	What is my happiest way to spend a Friday night?
한 달 안에 이루고 싶은 목표가 있는가?	Is there a goal I want to achieve within a month?
오늘 가장 좋았던 시간은 언제인가?	What was the best time of my day?
누군가 나를 위해 요리해준 적이 있는가?	Has someone cooked for me recently?
가장 최근에 받은 손편지는 누구에게서 온 것인가?	Who sent me the last handwritten letter?
최근에 가장 많이 웃었던 적은?	When was the last time I laughed a lot?
나를 감성에 젖게 만드는 것은?	What makes me emotional?
오늘 상처받은 일이 있는가?	Did something hurt me today?
좋은 아이디어를 떠올려야 할 때 찾는 곳은?	Where do I go to brainstorm good ideas?
무작정 다가가 말을 걸고 싶은 사람이 있는가?	Is there someone I want to approach and talk to?
나를 한 단어로 표현한다면?	Describe myself in one word.
토요일 오전을 보내는 나만의 가장 행복한 방법은?	What is my happiest way to spend a Saturday morning?
내 몸 중에서 가장 마음에 드는 곳은?	What part of my body do I like the most?
5년 동안 교도소에 갇히게 된다면 입소 전날 무엇을 하고 싶은가?	If I were to be imprisoned for five years, what would I want to do the day before?
앞으로 일어날 일을 상상할 때 최선의 경우를 떠올리는 편인가, 최악의 경우를 떠올리는 편인가?	When imagining the future, do I envision the best or the worst case?
당장 기분을 좋게 하는 비법이 있는가?	Do I have a way to instantly boost my mood?
초등학교 2학년생에게 해주고 싶은 조언은?	What advice would I give to a second grader?
최근에 들은 충격적인 소식은?	What was the most shocking news I heard recently?
논리보다 직감에 의존하는 편인가?	Do I rely more on logic or intuition?
사람들의 무리한 부탁을 잘 거절하는 편인가?	Am I good at declining unreasonable requests?
좋은 소식과 나쁜 소식 중에 무엇을 먼저 듣고 싶은가?	Do I prefer hearing good news or bad news first?
나만의 기분 전환 방법은?	What is my method for changing my mood?
광적으로 좋아하는 분야가 있다면?	Is there a field I am crazy about?
나의 가장 큰 꿈은 무엇인가?	What is my biggest dream?
나는 새로운 ___________을(를) 원한다.	I want a new ___________.
오늘 하루를 한 단어로 표현한다면?	If I could express today in one word, what would it be?
현존하는 유명인 중에서 술 한잔하고 싶은 사람은?	Which famous person do I want to have a drink with?
내가 믿고 의지하는 사람은?	Who do I trust and rely on?
최근에 한 말실수가 있다면?	Have I made any verbal blunders recently?
누군가의 행동을 더 이상 참기 어려울 때 사실대로 말할 수 있는가?	Can I honestly tell someone if I can no longer tolerate their behavior?
앞으로도 쭉 변하지 않았으면 하는 것은?	What do I hope will never change?
가장 듣기 좋은 칭찬은?	What is the best compliment I could hear?
나를 잘 나타내주는 노래는?	What song represents me well?
오늘 나를 놀라게 한 것은?	What surprised me today?
몇 살까지 살고 싶은가?	How long do I want to live?
집 안에서 뒹굴거리기 vs. 밖에 나가서 놀기?	Staying in and lounging vs. going out and playing?
내 삶에서 가장 결별하고 싶은 것은?	What do I most want to part with in my life?
사람들에게 가장 즐겨하는 질문은 무엇인가?	What is my favorite question to ask people?
절대로 버릴 수 없는 물건을 하나만 적어보자.	Name one item I can never throw away.
하루에 한 시간이 늘어난다면 뭘 할까?	If I had an extra hour every day, what would I do?
마지막으로 절정의 행복을 느꼈을 때는 언제인가?	When was the last time I felt peak happiness?
오늘을 색깔로 표현해보자.	Describe today in a color.
오늘 하루와 어울리는 시와 노래 구절을 적어보자.	Write a poem or song lyrics that fit today.
죽기 전에 꼭 하고 싶은 일이 있다면?	What is something I must do before I die?
(노력 없이) 한 가지 재능을 얻을 수 있다면 무엇을 고르겠는가?	If I could gain one talent effortlessly, what would it be?
오늘 하루를 세 단어로 표현한다면?	Describe today in three words.
하루 동안 초능력을 가질 수 있다면 어떤 것을 원하는가?	If I could have a superpower for a day, what would I want?
닮고 싶은 문학작품 속 주인공은?	Which literary character do I want to emulate?
나의 가장 큰 장점은?	What is my biggest strength?
나를 이루고 있는 특징 세 가지를 적어보자.	Write down three characteristics that define me.
내가 생각하는 꿈의 직장은?	What is my dream job?
지금 기분을 다섯 글자로 표현한다면?	Describe my current mood in five words.
내가 생각하는 환상적인 휴가는?	What is my idea of a perfect vacation?
나는 운이 좋은 편이라고 생각하는가?	Do I consider myself lucky?
내 인생을 바꿀 만한 영감을 준 사람이 있다면?	Who inspired me enough to change my life?
휴식이 필요하다고 느끼는가? 무엇으로부터?	Do I feel I need a break? From what?
집이란 무엇이라고 생각하는가?	What do I think of as home?
상처받은 마음을 치유하는 나만의 방법을 적어보자,	What is my method for healing a wounded heart?
오늘 지나치게 많이 사용한 말은?	What word did I overuse today?
오늘 가장 두드러진 감정은 무엇인가?	What was my most prominent emotion today?
오늘 ___________이(가) 지나치게 많았다.	There was too much ___________ today.
어머니에게 하고 싶은 질문은?	What question would I ask my mother?
아무에게도 하고 싶지 않은 이야기가 있는가?	Is there something I never want to tell anyone?
나는 왜 일하는가?	Why do I work?
오늘 떠올린 생각 중에 가장 엉뚱한 것은?	What was the most absurd thought I had today?
오늘 하루 중 기억에 남기고 싶은 것은?	What memory from today do I want to keep?
남모르게 간직한 열정이 있다면?	Is there a hidden passion I have?
비밀을 털어놓을 수 있는 사람을 한 명만 꼽는다면?	If I had to choose one person to share my secrets with, who would it be?
나의 가장 큰 단점은 무엇인가?	What is my biggest flaw?
세상을 떠난 유명인 중에서 저녁식사를 함께하고 싶은 사람은?	If I could have dinner with a famous deceased person, who would it be?
딱 하루만 인생을 바꿀 수 있다면 누구와 바꾸겠는가?	If I could swap lives with someone for a day, who would it be?
좋은 적이란 과연 존재할까?	Do good enemies exist?
지금까지 이룬 것 중 성취감이 가장 컸던 일은?	What was my most fulfilling achievement?
타임머신을 타고 과거로 돌아가 꼭 바꾸고 싶은 일이 있다면?	If I could take a time machine to change one thing in the past, what would it be?
주변인의 죽음 중 가장 슬펐던 사람은?	Whose death affected me the most?
직감을 믿는 편인가?	Do I trust my instincts?
지금 이 순간 가장 그리운 사람은?	Who do I miss the most right now?
나를 냉소적으로 만드는 것은?	What makes me cynical?
날씨 예보처럼 기분을 예측한다면 앞으로 내 기분은 ___________다.	If I were to predict my mood like the weather, what would it be?
딱 하루만 원하는 직업으로 살 수 있다면 무엇을 선택하겠는가?	If I could have any job for a day, what would it be?
___________은(는) 완벽하다.	___________ is perfect.
내가 버려야 할 것은 무엇인가?	What do I need to let go of?
나는 돈을 충분히 버는가?	Am I earning enough money?
가장 답하기 좋아하는 질문은 무엇인가? (하나 이상 가능)	What is my favorite question to answer? (Can be more than one)
오늘 하루를 140자 내외로 표현해보자.	Describe today in 140 characters or less.
현재 삶에서 가장 만족스러운 부분은?	What is the most satisfying part of my life right now?
나는 가르치는 사람인가, 배우는 사람인가?	Am I a teacher or a learner?
나는 5년 후에 어떤 모습일까?	What will I be like in five years?
오늘 배운 것은 ___________다.	Today I learned ___________.
두려움 하면 떠오르는 것은?	What do I think of when I hear 'fear'?
지금 이 순간 무엇을 좇고 있는가?	What am I chasing right now?
사소하지만 고질적인 문제를 하나 적어보자.	Name a small but chronic problem.
나는 ___________에 인내심이 없다.	I have no patience for ___________.
___________은(는) 정말 말도 안 된다.	___________ is just nonsense.
오늘 거의 ___________할 뻔했다.	I almost ___________ today.
나의 마지막이 어떨지 알고 싶은가?	Do I want to know how my end will be?
재산이 얼마나 있으면 행복할까?	How much money do I need to be happy?
내가 대단한 이유는?	Why am I amazing?
거부할 수 없는 것은?	What is something I can't resist?
새로운 곳으로 이사한다면 어느 도시로 가고 싶은가?	If I could move to a new place, which city would it be?
내가 생각하는 가장 평화로운 장면은?	What is my idea of a peaceful scene?
무엇이 나를 나답게 만드는가?	What makes me who I am?
친구란 ___________다.	Friends are ___________.
가장 위대하다고 생각하는 직업은?	What is the greatest job in my opinion?
만 원을 가장 알차게 쓸 수 있는 방법은 무엇일까?	What is the best way to spend 10,000 won?
인터뷰하고 싶은 유명인사는?	Who is a famous person I want to interview?
좋은 친구란 무엇일까?	What makes a good friend?
자서전을 쓴다면 첫 문장을 어떻게 쓰고 싶은가?	If I wrote an autobiography, what would be the first sentence?
소원 세 가지는?	What are my three wishes?
내 삶의 목적은 무엇인가,	What is the purpose of my life?
사람은 변할 수 있는가,	Can people change?
평생 한 사람만 사랑하면서 살 수 있다고 생각하는가?	Do I think I can love one person my whole life?
궁극적으로 어떤 사람이 되고 싶은가?	Ultimately, what kind of person do I want to be?
현재 나의 꿈을 가로막는 가장 큰 장애물은 무엇인가?	What is the biggest obstacle blocking my dream?
나를 불행하게 만드는 것은?	What makes me unhappy?
내가 잃을 수밖에 없는 것은?	What am I bound to lose?
완벽한 하루를 위해서는 무엇이 필요한가?	What is needed for a perfect day?
내 묘비에 남기고 싶은 말은?	What do I want on my tombstone?
현재 내 삶의 중요한 키워드 세 가지는?	What are three key terms in my life right now?
내가 생각하는 프로페셔널의 조건은?	What are the conditions for being professional in my opinion?
들으면 속이 후련해질 것 같은 말은?	What would be relieving to hear?
오직 20대에만 누릴 수 있는 특권은 무엇일까?	What are the unique privileges of being in my twenties?
나의 소울 푸드는 무엇인가?	What is my soul food?
새로운 관심사는 무엇인가?	What is my new interest?
가장 최근에 방문한 식당은? 무엇을 먹었는가?	What was the most recent restaurant I visited? What did I eat?
오늘 하루가 힘들었던 이유는 _______________다.	Today was difficult because _______________.
오늘은 평범한 하루였는가? 그렇거나 그렇지 않은 이유는?	Was today an ordinary day? Why or why not?
나는 오늘 ____________을(를) 잃었다.	Today I lost ____________.
나는 리드하는 쪽인가,	Am I a leader?
빌리거나 빌려준 돈이 있는가?	Do I have any borrowed or lent money?
오늘 입은 옷차림 중에서 가장 오래된 것은?	What is the oldest piece of clothing I wore today?
만약 창업을 한다면 어떤 일을 하고 싶은가?	If I start a business, what would I want to do?
안전을 추구하는가,	Do I prioritize safety?
오늘의 나를 예술 사조로 표현한다면? (초현실주의,	If I express today's me as an art movement? (Surrealism,
누구와 함께 사는가?	Who do I live with?
오늘 하루 슬퍼할 일이 있었는가? 그 강도를 1~10으로 표현한다면?	Was there something sad today? Rate the intensity from 1 to 10.
오늘 무엇을 타고 출근했는가? 걸어서? 지하철을 타고?	What did I commute with today? Walking? Subway?
지금 사랑하고 있는가?	Am I in love right now?
지금 몸에 걸친 것 중에서 가장 비싼 물건은?	What is the most expensive thing I'm wearing right now?
내가 아는 가장 정신 나간 사람은 누구인가?	Who is the craziest person I know?
요즘 유행하는 말을 세 개만 적어보자.	List three trendy words these days.
오늘 하루 간절히 원했지만 얻지 못한 것이 있다면?	What did I desperately want today but couldn't get?
나는 독창적인 사람인가,	Am I an original person?
마지막으로 아팠던 적은 언제인가?	When was the last time I was sick?
나의 원수는 누구인가?	Who is my enemy?
___________을(를) 실험하는 것은 좋은 생각이 아니다.	It's not a good idea to experiment with ___________.
오늘 무시하고 싶었던 사람은 ___________다.	Today I wanted to ignore ___________.
가장 최근에 본 영화는?	What is the most recent movie I've watched?
부인할 수 없는 팩트(fact)는 무엇인가?	What is an undeniable fact?
무엇을 위해 기도하는가?	What do I pray for?
오늘 가장 먼저 먹은 음식은?	What was the first thing I ate today?
오늘의 뉴스 기사를 하나 적어보자.	Write down a news article for today.
발라드와 댄스 중에 어떤 음악을 선택하겠는가?	Do I prefer ballads or dance music?
내가 한 거짓말 중에 가장 큰 파장을 불러일으켰던 것은?	What is the biggest lie I told that had a major impact?
오늘 일어나기를 바라는 일은?	What do I hope will happen today?
가장 최근에 주문한 테이크아웃 음식은?	What was the most recent takeout food I ordered?
지금 어떤 색깔의 옷을 입고 있는가?	What color clothes am I wearing now?
오늘 빼먹은 집안일은 ___________다.	What housework did I skip today?
오늘 욕을 몇 번이나 했는가?	How many times did I swear today?
누군가 무슨 일을 하냐고 물을 때 뭐라고 답하는가?	What do I say when someone asks what I do?
절대 일어나지 않았으면 하는 일은?	What is something I hope never happens?
부모님은 나를 어떻게 생각하실까? (전화해서 여쭤봐도 된다.)	What do my parents think of me? (I can call and ask.)
현재 지갑에 돈이 얼마나 있는가?	How much money is in my wallet right now?
나는 감성적인 사람인가,이성적인 사람인가?	Am I an emotional person or a rational person?
내가 행복하게 만들어줄 수 있는 사람은 누구일까?	Who can I make happy?
가장 좋아하는 꽃이나 식물이 있다면?	Do I have a favorite flower or plant?
나는 깔끔한 사람인가,지저분한 사람인가?	Am I a neat person or a messy person?
마지막으로 수영을 한 적은 언제인가?	When was the last time I swam?
정말 신나는 하루였다. 그 이유는 ___________다.	Today was really exciting. Why?
어머니에게 하고 싶은 말은?	What do I want to say to my mother?
오늘 해야 할 일 중 미루고 싶은 일은 무엇인가?	What is something I want to procrastinate on today?
최근에 한 가장 창의적인 일은?	What was the most creative thing I did recently?
현재 탐구하고 있는 분야가 있다면?	Is there a field I'm currently exploring?
오늘 나에게 애정을 보여준 사람은?	Who showed me affection today?
마지막으로 참석한 모임은?	What was the last meeting I attended?
현재 나의 헤어스타일은?	What is my current hairstyle?
오늘 나를 괴롭힌 일들을 적어보자.	Write down the things that troubled me today.
현재 나에게 위안을 주는 것은?	What gives me comfort now?
산과 바다 중 어느 곳이 더 좋은가?	Do I prefer mountains or the sea?
나의 건강 상태를 1~10으로 나타낸다면?	Rate my health from 1 to 10.
오늘은 ___________을(를) 입었다.	Today I wore ___________.
마지막으로 먹은 과일은 무엇인가?	What was the last fruit I ate?
가족 중 가장 가까운 사람은?	Who is the closest person in my family?
오늘 나를 걱정하게 만든 것은 ___________다.	What worried me today?
가장 좋아하는 전자기기는?	What is my favorite electronic device?
더 가까워지고 싶은 사람이 있다면?	Is there someone I want to get closer to?
가장 최근에 영화관에서 본 영화는?	What was the last movie I watched in a theater?
마지막으로 울었던 적은 언제인가?	When was the last time I cried?
조만간 참여해야 하는 모임이나 행사는?	What is an upcoming event or gathering I need to attend?
전쟁이 일어날 것이라고 생각하는가?	Do I think war will break out?
마지막으로 피자를 먹은 적이 언제인가? 어떤 피자였는가?	When was the last time I ate pizza? What kind was it?
주량이 얼마나 되는가?	How much can I drink?
마지막으로 가본 바다는?	What was the last sea I visited?
오늘 취소한 일은 ___________다.	What did I cancel today?
사랑과 우정 중에 하나를 고른다면?	Love vs. friendship?
___________은(는) 재미있다.	___________ is fun.
나의 신조는 무엇인가?	What is my motto?
오늘이 유쾌했던 이유는 ___________다.	Why was today pleasant?
부모님과 마지막으로 대화를 나눈 적은 언제인가?	When was the last conversation I had with my parents?
나의 아킬레스건은 무엇인가?	What is my Achilles' heel?
지금 양말을 신고 있는가?	Am I wearing socks right now?
가장 최근에 만든 요리는?	What was the last meal I cooked?
(과거 또는 현존하는) 화가 중에서 초상화를 부탁하고 싶은 사람은?	Which past or present artist would I ask for a portrait?
성실하게 일하는 편인가,꾀를 부리는 편인가?	Am I diligent or do I tend to slack off?
지금 무슨 냄새가 나는가?	What do I smell right now?
오늘 하루가 힘들었던 이유는 _______________다.	Today was difficult because _______________.
더위를 피하는 나만의 방법은?	What is my way to beat the heat?
차가운 물로 샤워하는 게 좋은가,뜨거운 물로 샤워하는 게 좋은가?	Do I prefer showering with cold or hot water?
지금 있는 곳을 묘사해보자.	Describe where I am right now.
내가 피노키오라면 나의 코는 지금 얼마나 길어졌을까?	If I were Pinocchio, how long would my nose be right now?
가장 최근에 비행기를 탄 적은?	When was the last time I took a flight?
오늘 내가 망가뜨린 것은 ___________다.	Today I broke ___________.
최근에 가장 맛있었던 식사는?	What was the most delicious meal I had recently?
마지막으로 보낸 문자 메시지를 적어보자.	What was the last text message I sent?
지금 도망치고 싶은 일이 있다면?	Is there something I want to escape from right now?
뷔페에서 가장 먼저 먹는 음식은?	What do I eat first at a buffet?
오늘 해야 할 일을 모두 끝마쳤는가?	Did I finish everything I needed to do today?
오늘 나를 가장 신경 쓰이게 한 것은 ___________다.	What bothered me the most today?
나는 어느 팀에 소속되어 있는가?	What team am I part of?
매일 먹어도 질리지 않는 음식이 있다면?	Is there a food I can eat every day without getting tired of it?
창의성 발휘에 필요한 요소를 적어보자.	What are the elements needed to foster creativity?
아버지에게 하고 싶은 말은?	What do I want to say to my father?
마지막으로 운동한 것은 언제인가?	When was the last time I exercised?
나만의 승리 구호가 있다면?	Do I have a victory slogan?
오늘 저녁으로 뭘 먹었는가?	What did I eat for dinner?
가장 좋아하는 시리얼 브랜드는?	Your favorite brand of cereal?